text	label	prediction
还行 还差3个字	正面	正面
还行，算得上近期比较不错的电影了	正面	正面
难得的佳作，有剧情，有搞笑，有感动。没有硬来的感觉，很值得一看	正面	正面
这家店其实最让我惊喜的是服务，虽然是遇到点小问题，但是工作人员一直道歉并帮忙解决，真的是客户至上啊。	正面	正面
剧情很好，幽默搞笑还有刀，很感人	正面	正面
好看好看的的	正面	正面
感动，好笑，好看	正面	正面
真的好看，喜剧的外壳，立意却深刻👍🏻	正面	正面
还可以，挺感人	正面	正面
剧情看似很沉重，但是通过以喜剧性的表达方式，感觉没有被代入感。画面还是很壮观，很好看的，可以感受到中国的电影工业水平也是与时俱进，世界进入中国科幻时代。	正面	正面
沈腾真的太搞笑了，出场笑点就来了	正面	正面
不错，带孩子去的。	正面	正面
小时候就有小行星撞击地球的幻想，算是圆满了。	正面	正面
说实话真的一般，如果不是沈腾马丽就更差了	负面	负面
不好看。没有亮点	负面	负面
🌟 推荐 很不错  😊 演技	负面	正面
棒极了，沈马组合从来就不会让你失望。	正面	正面
挺棒的电影，电影院笑声一片!感动的地方也有!	正面	正面
马丽真的好好看、全程笑点、后面结局也可以接受	正面	正面
去看之前看网上评价都很好，期待值蛮高的 但看了之后觉得也就还行，没想象中好看。 笑点挺密的，之前看评论有人说笑到肚子疼。。。 我本人是觉得没有特别特别搞笑的点，结尾也一般，有些台词倒是挺好。 不抱太高期望值还是蛮推荐的，毕竟喜剧带给人快乐。	正面	正面
还可以，正常水平	正面	正面
有笑有泪，普通人也可以成为英雄	正面	正面
超级好看！都给我去看！！！！	正面	正面
袋鼠那里我尬出了三室一厅，看不到一点主线，单纯为了搞笑而搞笑，后面还强行煽情，以为这样子可以升华主题？而且整个剧情就不科学，也就14岁以下的看得有味，但凡上完初中的都不能理解种种设定，把观众当傻子了，整就是一个快餐电影，看完也没有值得感悟和值得回味的地方，去看了浪费钱和时间。	负面	负面
太搞笑了，加油	正面	正面
超级好看，好喜欢沈腾马丽	正面	正面
以为是大团圆结局，结果是悲剧英雄结局，搞笑之余又有深度，值得一看	正面	正面
剧情很精彩，画面也很壮美，结局很感人，演技也到位，值得推荐！	正面	正面
剧情总体很完整，也很搞笑，一如既往的支持沈腾	正面	正面
好看，搞笑又有点感动	正面	正面
挺好看的 爆笑	正面	正面
电影挺好看的，沈马演技都在线，喜欢	正面	正面
名留影史 挑不出什么毛病	正面	负面
剧情跌宕起伏值得一看	正面	正面
有哭有笑，开心，哈哈哈	正面	正面
非常好看👍	正面	正面
Wonderful movie, you will laugh, cry and hope	正面	正面
剧情丰满，不亏是腾哥，电影太好看了。	正面	正面
好看🔴🔴	正面	正面
很好，很不错！	正面	正面
还不错，笑中有泪点	正面	正面
剧情真的很不错 画面很震撼	正面	正面
喜剧之王，给力	正面	正面
好看，后面真的很感人	正面	正面
有点荒诞~笑点不算太多！	正面	正面
挺好看的，值得看	正面	正面
9分只因悲伤结尾！！！！！！！	正面	正面
可以看哦好好	正面	正面
搞笑也不搞笑，也不科幻，最后强行煽情，唉！	负面	负面
一般般，很尴尬	负面	负面
值得一看 开心笑到哈哈	正面	正面
喜欢演员，自然也就感觉影片好看。	正面	正面
太棒了.很久没看这么好看的电影了。	正面	正面
值得一看！也看着苦笑不得	正面	正面
笑着笑着就哭了！！	正面	正面
好看！感动呜呜呜呜	正面	正面
可以的还行的	正面	正面
啥都挺好就是主角结局不是很完美🥹🥹🥹	正面	正面
很少黑五星，但是这个影片是真的顶，作为一个喜剧，少有的做到了笑点不尬，而且全员演技很到位，画面做的也很美，笑的很大声，最后也会热泪盈眶，在目前这个什么人都能做喜剧得市场，这样一部影片无论从体验，画面，立意上来看都是少有的高质量影片，如果有时间的话真的值得一看	正面	正面
好看看好看看	负面	正面
还好吧了的哦	正面	正面
剧情一般，特效还行，也就是冲着沈腾马丽才去看的，看看还行吧。	正面	正面
真的无聊死...睡着了...	负面	负面
喜剧与感动同在	正面	正面
有演技有泪点	正面	正面
能让你笑几次，对得起这个票钱了。不要想着谈论逻辑，合理性之类的	正面	正面
剧情很好，沈腾马丽对戏，反转多，有搞笑有深情，同时也很激励人心！值得推荐！冲冲冲！	正面	正面
期望越高失望越大吧	负面	负面
棒极了，挺好看	正面	正面
感人的故事真的很不错	正面	正面
不俗套，也搞笑，不错不错	正面	正面
幽默，感人，值得一看	正面	正面
应该春节档的贺岁片才对。	正面	正面
含腾量可以，剧情好玩，带女朋友去看很不错	正面	正面
很不错，值得一看。	正面	正面
棒极了有笑点有泪点	正面	正面
电影很细腻的刻画出了男主角内心的矛盾和挣扎。救不救金刚鼠？救不救众生？救，就要牺牲自我。生活中有一种人，普普通通是他的人设，碌碌无为是他的日常，然而关键时刻，他会挺身而出，逆向而行。内心光明的人总会给他人带来深深感动，电影唯一的缺憾就是核弹的设定，那个锤子太小了，重量感力量感不强。	正面	正面
喜欢看沈腾和马丽演的，好看滑稽幽默搞笑	正面	正面
还不错的呢~~~~	正面	正面
挺好看的，沈腾搞笑是认真的	正面	正面
逻辑性差点，感觉质量不如往年，带孩子乐一下倒不错	负面	正面
剧情不错画面不错强烈推荐	正面	正面
一般般也就那样	正面	负面
剧情一般，太单一了。主要是玩梗，有些梗搞笑，但整体一般	负面	负面
很有意思，但是整体套路有点老套，喜剧开头，悲剧结尾	正面	正面
可能是看过漫画了吧，期待值还好。 不过影院我要给差评，太！热！了！！！	负面	正面
剧情整体还是蛮不错的，有笑点也有泪点，值得一看，唯一就是后面的情节有点太不符合科学了哈哈哈哈 😂	正面	正面
一般真的很一般	正面	负面
好看，喜欢开心麻花。	正面	正面
哎。。。。咋说呢？看预告片吧，搞笑的都在那	负面	负面
电影超好看，沈叔叔的演技超级好，就是最后彩蛋人都走完了😃😂	负面	正面
太好看了啊 一定要去看 笑着笑着就哭了 哭着哭着就笑了 好久没看到这么好看的电影了 上一次还是在上一次	正面	正面
非常好！既搞笑又感动	负面	正面
比较好笑 有点动人	正面	正面
您明明哦明明哦	正面	正面
咱就是说，这个导演导得也不行啊，一般般，没有特别惊艳，令人吐槽	负面	负面
好想去看看这个节目就是	正面	正面
就是一般啊 没觉得有多搞笑  而且就是无厘头罢了  看纯纯是因为沈腾	负面	负面
好看真的推荐	正面	正面
开心麻花出品就是精品，沈马组合就没让人失望过。笑中有泪，展现普通平凡人也有高光的一面。好作品。	正面	正面
非常好，今年最好看的一部	正面	正面
没有这个杀手不太冷静好看	正面	负面
很喜欢，欢乐的背后满是正能量，结局让人泪目。	正面	正面
孩子喜欢很高兴	正面	正面
画面剧情非常好，十分感动，前面中间笑点不断，人生的哲理也许多，有许多意想不到的小惊喜，有喜有感人，总之一句话，沈腾出品，必属精品 🌟 推荐  😊 演技  😭 哭点	正面	正面
独行月球果然不虚此行，虽然人比较多，但架不住美呀，全程惊喜连连真的超级满意，根据推荐来的，省了自己慢慢做功课的时间，省时又省力，赞赞赞(˘͈ᵕ ˘͈❀)	正面	正面
一般，也就一般	负面	负面
很棒，看起来不错	正面	正面
还好。有负评分。	负面	正面
很好看，沈腾的作品支持	正面	正面
依旧是没有逃脱爆米花喜剧片的步伐。喜剧元素中规中矩带有麻花的特点。影片剧情升华的铺垫不够，观众共情不足。特效层面进步明显	负面	正面
很好，，比较搞笑	正面	正面
刚刚看完，抄袭嫌疑太大，绝世天劫和火星救援痕迹太重，开心麻花已然跟不上大众的需求了	负面	负面
去去去收拾收拾	正面	正面
不错，推荐，前面搞笑，后面催泪。	正面	正面
沈腾新时代喜剧之王	正面	正面
感人虽然结局是be，2022最喜欢的一部	正面	正面
不要找bug，就图一乐，挺爽！	正面	正面
笑点很多，没想到最后煽情了一把，还是值得一看的	正面	正面
还好。虽然尬点不少，但是总体还可以。	正面	正面
比较搞笑。。	正面	正面
缝合怪 不好看	负面	负面
不错 碰到了个女朋友	正面	正面
好好地演的喜剧片是赚不了钱？非要联系个爱情这些东西？衔接的贼尴尬	负面	负面
好好尴尬两次	正面	负面
开心麻花的老套路了，感觉都审美疲劳了	负面	负面
很不错的一部电影，不愧是沈马组合，期待更好的作品	正面	正面
非常不错呦。。。。	正面	正面
好看，值得去看。	正面	正面
真的超级好看！又好哭又好笑，我要二刷！	正面	正面
带上孩子去看挺好的，推荐。	正面	正面
……还hao ba	正面	正面
可能期待太高，看下来还行。	正面	正面
非常搞笑，值得去看一下，带着家人	正面	正面
很好很好好，喜剧看着看着竟然哭了	正面	正面
挺好看的，幽默。	正面	正面
超级好看，所以看电影前千万不要看剧透，前期全是笑点，后面也有感动的点	正面	正面
还算可以吧！	正面	正面
又搞笑  又感动	正面	正面
很搞笑也很感动！最后不喜欢！沈叔叔牺牲了！	正面	正面
挺搞笑的 也有泪点	正面	正面
搞笑类电影！	正面	正面
全场太热，剧院太差，敷衍浮躁	负面	负面
太好看了。虽然很多点行不通，但是整体来说搞笑又催泪，加油加油	正面	正面
都给我去看😍 😍 😍 😍 😍   😂 笑点    很好笑很好笑很好笑很好笑主要是沈腾哥就好笑 🥚 彩蛋 结局虽然不完美但合理 彩蛋弥补了这个遗憾 🎉闪光点 全世界的英雄😭  🌟 推荐 都去看都去看都去看都去看都去看 😊 演技 全员演技在线😭   很好笑也很好哭	正面	正面
不给退票差评，卡时间不合理	负面	负面
很搞笑也很感动	正面	正面
搞笑又感人！！	正面	正面
CG做的不错，剧情一般。	正面	正面
前面还行、后面没意思	正面	正面
还不错，小朋友喜欢	正面	正面
好端端的沈氏喜剧，非常完美地诠释了喜剧的内核是悲剧这个道理。在短暂的时间内经历小人物的大喜大悲，也提出了值得思考的人生问题。虽然和流浪地球的大致情节很类似，但艺术造诣要高许多。对于人物绝境的刻画，也要更深刻。就只举一例，电影中袋鼠这个形象的存在，比流浪地球里俄国人的存在要更有艺术特色。但是一定要以科幻月球为背景，只会觉得剧情套作，内容大致似曾相识。而且单论科技元素，也不如流浪地球。这就使得沈氏喜剧的优势没有发挥出来，反而落入前人已经做过的窠臼。未来推出更好的作品的希望，仍然在于讲好小人物的故事，发掘人性的光芒，思考人生的问题。至于科幻领域，不论流浪地球算是珠玉在前还是怎样，以宇宙为背景的，开心麻花还是应该不主攻于此。	负面	正面
很好看，前面很搞笑后面很感人	正面	正面
一般般把，笑点不是很高，不值得去电影院看，等手机上可以看了再看比较划算！	正面	负面
非常好，说不好看的都水军	正面	正面
ok，等了很久没让我失望	正面	正面
这演的这啥呀是，有点尬…	正面	负面
我觉得很好看，有笑点有演技特效也不错	正面	正面
不错推荐去看	正面	正面
男朋友看哭了三次！非逼着我来评个满分 确实被感动了，人类也太渺小了，宇宙这么大，一天到晚烦恼个啥！	正面	正面
很好，推荐！	正面	正面
快去看。奈何本人没文化，一句WO cao走天下 。真好看	正面	正面
科幻，喜剧，情怀，都很勉强。	负面	正面
又搞笑有感动，一直喜欢开心麻花的电影，希望越做越好	正面	正面
好看，有喜也有悲，虽然有的镜头有点扯，但是整体还不错，推荐	正面	正面
很好看  真的很棒	正面	正面
有一点点尬。	正面	负面
好看，励志又感人🌹🌹🌹	正面	正面
确实可以 还不错	正面	正面
悲剧，喜剧l	正面	正面
#藤井树观影团感谢主办方本次上海首场观影活动，由开心麻花沈马组合主演`张吃鱼导演的一部展现极致孤独又史诗级浪漫的科幻喜剧片。影片多处笑点与感动交揉一并恰适其氛的插曲与月球特效场景颗粒感般的极佳视听效果感染着观影者，着重刻画了独孤月与金刚鼠奋力回归过程经历的关系升温和情感表达，同时与倾注身心于马蓝星深深浓浓爱情以及拯救地球奉赴生命的大爱情怀极尽丰富传达着悠长而深远的浪漫。这不仅仅是一部电影，它是带你穿梭浩瀚`乘风落叶变成流星坠入你心中的光。	正面	正面
一般，看到一半睡着了	正面	负面
真难看，很失望啊	负面	负面
中规中矩的片子，实在没看的值得看一下打发时间，剧情节奏把控得很好	正面	正面
good！！含腾量高	正面	正面
电影很好看，隔两座，也算是一种态度	正面	正面
算是沈腾最差的电影了可能	负面	负面
韩国料理**默默章鱼小丸子	正面	负面
还行吧………	正面	正面
确实不错，娃儿四岁都看哭了……	正面	正面
电影的特效真的震惊我了，还有几位主演情感传递交流都很不错，值得去看一看。笑点是一触即破的那种很好看，已经二刷了	正面	正面
很搞笑的哈哈	正面	正面
沈某人发挥稳定	正面	正面
前面挺搞笑的	正面	正面
带5岁儿子去的，不该带孩子去看，坐不住。	正面	正面
特效很好看，还比较推荐	正面	正面
中国科幻电影的里程碑，相比《流浪地球》剧本更加流畅，节奏更加丝滑，人物更加深刻，情感更加自然，画面更加唯美。是一部有笑有泪，有血有肉，热血澎湃的好作品。一切都那么荒诞又合理，贡献了多个精彩的名场面，值得囊括一批技术类奖项。沈腾的演技也是无可挑剔，甚至有几处觉得是真的帅！怀着激动的心情看完电影，观感太棒了！ 🎉闪光点  😭 哭点  🌅 画面  😊 演技  🌟 推荐	正面	正面
值得去看，不错不错。	正面	正面
沈马真甜！电影太棒了。	正面	正面
😊 演技 沈腾是实力派演技派，完美	正面	正面
哈哈哈好搞笑啊	正面	正面
真的爱死了，前面笑死，后面哭死，有人说有点夸张，但是我觉得正正好啊救命，这样才好玩啊哈哈哈，当然有些特效有点假是真的，但一点也不影响观影，最后表白沈腾叔叔，太帅了！！！！！不愧是军艺（前）校草！！	正面	正面
我看过最精彩的中国人拯救地球电影，打破之前那些美国树立的“英雄”救地球，很好👍🏻	正面	正面
推荐观看，赞	正面	正面
还可以，笑点比较突出。但整体没有预想的好，可能期望太高了。	正面	正面
一般 情节不是很丰富	负面	正面
…比较失望。	负面	负面
看个热闹就得了  穿帮镜头太多了	正面	正面
今天我妈的姐姐去星星上陪姥姥了	正面	正面
剧情全程喜感欢快，贼喜欢	正面	正面
感觉挺好看的	正面	正面
幽默中透露人性，很感人	正面	正面
好👌🏻，	正面	正面
电影还可以呦	正面	正面
搞笑又感动，挺好看	正面	正面
好看，，喜欢	正面	正面
演技在线 画质清晰	正面	正面
不错不错我挺喜欢	正面	正面
期待过高，令人失望	负面	负面
特别喜欢 好看	正面	正面
很好 挺感人的	正面	正面
可以嘞，值得推荐啦	正面	正面
开心麻花永远不会失望！喜欢沈马组合，马丽好美在电梯那里和沈腾擦肩而过的镜头太惊艳了，喜欢那个可爱的大袋鼠，整部电影的插曲也都很好听太好听了！	正面	正面
挺好看的，值得	正面	正面
搞笑又有意义	正面	正面
沈腾马丽的电影必看！8分给电影2分给沈腾马丽	正面	正面
还好，很不错	正面	正面
不是喜剧嘛 结尾把我看哭了啊 🌟 推荐  😭 哭点  😂 笑点  🎉闪光点	正面	正面
挺搞笑的 挺感人的	正面	正面
太好看了 笑着笑着就哭了 沈腾演技一流	正面	正面
棒棒哒棒棒哒	正面	正面
剧情紧凑，整体不错	正面	正面
还不错，加油加油加油	正面	正面
还可以吧应该是	正面	正面
很好非常好很好	正面	正面
剧情很扯，但是有笑点，有感动。笑点是沈腾，就算没包袱，也是看他就想笑，哈哈！结局有点意料之外吧，总之，值得一看！	正面	正面
好看，一如既往的精彩	正面	正面
非常好太棒了	正面	正面
元素很丰富，有搞笑，有温情，有真情，有振奋，有悲情，有大爱，有明悟。整个电影看下来，主题简单明了，故事情节出乎意料，环环相扣，不断吸引调动情绪。黄色的太空服为电影色彩增添很多亮色，金刚鼠的出场帮助了喜剧笑点，科幻和温情因子的传达，场景画面效果也非常到位流畅自然。演员演技在线，特别是马丽沈腾，完美展示了人物特性。最后的结局，不圆满但是升华，好似人生，繁华峥嵘皆如烟，笑笑闹闹一场空，放下又好像放不下。遗憾是独孤月和马蓝星没有过一个拥抱，每颗星辰都是曾经，每处风沙都是回忆，茫然若失。我个人觉得比流浪地球好看，现在好看的喜剧电影不多，我还是挺喜欢开心麻花的出品。	正面	正面
一部要带着纸巾去看的喜剧，太好看了！	正面	正面
特效很震撼，搞笑也不少，从笑到肚子疼到热泪盈眶。我印象最深的就是黄子韬摘假发那段，不得不对演员的敬业而感动。	正面	正面
完美，太逗了	正面	正面
为了沈马组合去的，他们俩的默契无人能敌	正面	正面
不错不错，继续支持	正面	正面
好，不错不错。	正面	正面
🌟 推荐。	正面	正面
还可以，没有很惊艳。	正面	正面
剧情不错，前面挺搞笑的，就是最后看哭了	正面	正面
真的不好看，要啥啥没有。	负面	负面
看的还不错喜欢这部电影	正面	正面
完全不好笑啊，特效也经不起大银幕	负面	负面
很赞，不错👍	正面	正面
好看的，很感动！	正面	正面
很有创意，很赞	正面	正面
好看，但是又不是完全好看！感情线就那么的莫名其妙！有几处笑点有点强行出戏，最后的结尾有种说不出的感觉！情理之中，意料之中！一切就是那么的合理！最后强行煽情，我也完全没有感动！就是有点太刻意了！总体不过不失吧！最后总结，舔go bu 得house😂	正面	正面
剧情紧凑，笑点密集，好看	正面	正面
特别好，特别不错	正面	正面
还凑合，还凑合	正面	正面
还好看，值得看	正面	正面
有开心有感动，还不错👍🏻	正面	正面
谁不去看我都会伤心的Ok？ 好看好看好看！！	正面	正面
真的不错，推荐	正面	正面
“马蓝星 带我回家” 我可以永远相信马丽和沈腾演绎的故事呜呜呜	正面	正面
有趣，挺好看，又挺感动	正面	正面
一直想去看的，终于如愿以偿	正面	正面
开心麻花电影好看	正面	正面
特别棒，搞笑、感动、有意义，沈腾马丽果然从来不会让人失望	正面	正面
跟老婆看电影好开心啊哈哈	正面	正面
笑点尬，特效足，中规中矩	正面	负面
笑点泪点都不错，电影就是娱乐，玩呗，挺好的！	正面	正面
强行催泪了，是忘记在拍喜剧了吗？写死男主角	负面	负面
非常好的一部电影，7年再度合作，非常好看，有笑点有泪点！！！强烈推荐！！！！	正面	正面
为什么票房这么高，看了感觉很差劲	负面	负面
剧情不错，有笑点！	正面	正面
不错不错，很好。	正面	正面
挺好的，我很喜欢。	正面	正面
好看   有泪点	正面	正面
还可以，孩子挺喜欢	正面	正面
剧情说实话比较老套，但是由于是沈腾演的，忽略剧情当成搞笑剧看还是不错的。也是因为沈腾，半年没有走进影院的我，为了他特意去看。	正面	正面
很喜欢💕哈哈哈哈	正面	正面
作为喜剧片，没有特别好笑。作为其他类型的片子，完全不合格。但是特效什么的制作还是用了心的。	负面	正面
笑中带泪 剧情流畅 还不错	正面	正面
不伦不类，6分给特效和沈腾的演技，电影中间有些部分，有一种别样的浪漫，为了这部分我都想加个3分，考虑到整体一般，而且瞎打分数的太多了，7分吧，也就是沈腾和他演技上的超常发挥，这电影才值这个分数，换个主演就废了。值得一看。	正面	正面
挺好看，基本没尿点	正面	正面
剧情很搞笑，主角有强烈的责任感，整体氛围轻松	正面	正面
啊…有意思…真有意思….	正面	正面
三次厕所，一觉，前面值得看，后面太拖拽导致没兴趣了	负面	正面
准备看，看了预告有点火星救援的感觉	负面	正面
非常好看，有笑也有泪	正面	正面
看完了确实有点尬，没有太多的内涵和情节在里面，笑点都是一些开心麻花的包袱	负面	负面
好看，画质清晰	正面	正面
很搞笑，典型的开心麻花式电影	正面	正面
画面感很强！	正面	正面
棒👍🏻棒	正面	正面
挺好的，感染力和爆笑点都很强，真的值得观看，沈腾没让我失望过。真的我看到沈腾就仿佛看我自己，因为我跟他张的特别像 也许是失散多年的兄弟，哈哈，但是我是90后，沈腾是老前辈了。真的玛丽跟沈腾超出爱情感觉，那种爱真的是绝了，都是高级作品，突破2500个亿不是问题。	正面	正面
七夕和宝宝来看的   很不错	正面	正面
不错挺好看值得一看	正面	正面
看到独孤月的身影，真的和复联一钢铁侠抱着核弹冲向虫洞的身影重合了，真的好像，都是义无反顾，都是英雄；而且腾哥留着胡子和小罗伯特唐尼神似，俩人身影重合了。	正面	正面
画面很好，演技不错	正面	正面
电影真不错，好看	正面	正面
沈腾玛丽的喜剧片很喜欢看	正面	正面
沈腾的电影从来没让人失望过。	正面	正面
看了要打磕睡的电影你说好看吗？	负面	负面
好看，很多笑点，也很感动	正面	正面
波澜壮阔，好浪漫啊！地球是唯一的母亲，宇宙浩瀚，人类渺小，然精神伟大！	正面	正面
值个七分吧。。	正面	正面
yyds好看	正面	正面
挺好看的，剧情也不错，有笑点也有泪点	正面	正面
一般 为了搞笑而搞笑	正面	负面
作为观众，墙裂推荐，很不错。  票房二十亿起步。  有笑有泪还不尬，大场面处理的也很不错，还要求什么呢？  适合所有八到八十岁的宝宝。	正面	正面
好看，强推，搞笑中带着些浪漫	正面	正面
🌟 推荐 特别棒	正面	正面
离谱就 手电筒能在月球看到	负面	负面
绝对的好看，能把人笑死	正面	正面
从头就在笑，中间也有感人的地方 月球表面，陨石等都做的非常有质感，非常震撼 沈叔叔演的很细腻 好看！	正面	正面
值得一看！你！	正面	正面
环境非常不错，服务也很周到，还会有专业的指导🐂🍺	正面	正面
电影很好看，剧情很好，很感人～	正面	正面
结局我以为会有反转的，但是事实证明我想多了，马丽  沈腾爱你们	正面	正面
挺好看，带孩子去看的	正面	正面
好看好看。含腾百分之百	正面	正面
有笑点有泪点，推荐观看！	正面	正面
浩瀚宇宙我们不会永远一个人。。。 果然，沈叔叔的电影从来不会让我失望❤️	正面	正面
太搞笑了，全程都在笑	正面	正面
笑中带泪，很令人感动	正面	正面
确实笑点比较高	正面	正面
没有什么可以形容，一个字棒棒哒	正面	正面
感觉很不错啊 虽然套路还是套路 但是确实还不错	正面	正面
成功的喜剧往往都是以悲剧结尾。充满遗憾。宛如人生。	正面	正面
我的评论是不如人生大事	正面	正面
含腾量是高的，喜剧片至少让我笑得很开心，体验感还是很好的	正面	正面
宇宙这么大，我们会遇见。	正面	正面
太好看了，演技都很好，超级感人	正面	正面
可以。很好。	正面	正面
麻花的作品越来越棒了	正面	正面
特别好真的特别好 这部电影真的让我看的又哭又笑 沈腾马丽yyds！！！	正面	正面
有意义，没意思，笑点没那么多！全场就一人笑的要起飞了！影响观影心情！个人观点！勿喷！	正面	负面
感觉电影很好看，挺多搞笑的地方，而且结局挺出乎意料的	正面	正面
Be喜剧，开心麻花制作很不错	正面	正面
好看……，b	正面	正面
很好看！真的很好看！又好笑又感动！哭的不行了，沈腾马丽真的yyds ！最后coco 唱的主题曲也超好听！	正面	正面
超级好看啊，前面很搞笑，但后面很催泪	正面	正面
喜剧的背后是悲剧	正面	正面
结尾不圆满！	正面	正面
剧情精彩！	正面	正面
含腾量极高，一个字～爽！	正面	正面
产品很好，会回购，每次都这么让人满意，赞赞赞！	正面	正面
真的非常非常好看，含腾量100%，搞笑又感人，真的值得一看。	正面	正面
剧情一般，演技好，冲着沈腾马丽买的票	正面	正面
#独行月球 是人类勇气和希望的赞歌 ​“Country road takes me home” ​所有突破大气层带起火光的陨石都是我，​所有以第一宇宙速度发射的飞行器都陪伴我。	正面	正面
非常好，含腾量百分百	正面	正面
有笑点有泪点，特别不错的电影，沈腾一出场就忍不住想笑。金刚鼠真是没想到，刚子勇猛！马丽沈腾在这里看起来好年轻呀！	正面	正面
好笑有感人太棒了	正面	正面
挺逗的，太有意思了	正面	正面
还不错了，反正笑点挺多	正面	正面
剧情好的很。	正面	正面
很好看啊，我感觉不错	正面	正面
说实话有点失望，但我女儿喜欢也算值了	负面	正面
超级喜欢沈腾马丽，剧情好喜欢	正面	正面
我觉得还行，挺搞笑的。	负面	正面
电影很搞笑，影院环境也不错	正面	正面
结局不怎么好	正面	正面
是真的很一般	负面	负面
剧情略微老套，远不够硬科幻，但是喜剧科幻也不失为一种新的方式，悲尾略有些失落。我设想彩蛋里金刚鼠雕像旁站着独孤月	正面	正面
剧情不错，发挥了，该发挥的，一如既往的好支持	正面	正面
半喜半忧，沈马组合很不错	正面	正面
暑期绝对不能错过的喜剧片！！！开心麻花yyds！！！	正面	正面
好看啊真的。	正面	正面
一家三口去看的，电影内容很让人感动，哭了好几次。	正面	正面
不错，挺精彩的！让人又笑又哭。	正面	正面
陪孩子子去看的，是孩子喜欢的类型。	正面	正面
挺不错的，，，	正面	正面
可以的，半搞笑半科幻	正面	正面
6分 一般 沈腾的表演很好，但是剧情真的挺无聊。大多数的笑点都是砍flag，或者文字游戏。笑点比较低级。	负面	负面
好看，拍的不错	正面	正面
真的好无聊 睡觉了 不知道好评怎么来的 不知道演了些什么 没有笑点	负面	负面
还不错，好笑还有感动的片段	正面	正面
剧情一般，演技浮夸，开心麻花的水准越来越低了。不值得推荐	负面	负面
好看，笑点较多	正面	正面
前面很好看 就是结尾煽情 导演怎么能给他xisheng了 我还是喜欢搞笑剧情	正面	正面
非常好看，还是特别喜欢刚子	正面	正面
剧情搞笑很有沈氏幽默	正面	正面
不戳haokan	正面	正面
很好看，商家服务态度也很好。	正面	正面
好看，有泪点有细节	正面	正面
很好故事很感人	正面	正面
很好看，最后一点很感人…	正面	正面
棒棒棒，只能说开心麻花又要火了火了火！陈腾演技没的说	正面	正面
剧情类似 看到开头猜到结尾 特效还行 泪点有点 前期笑点也很多	正面	正面
还可以 一贯的麻花风	正面	正面
之前挺喜欢看沈腾的电影这次有点尬笑	负面	负面
我也比较喜欢开心麻花，观影比较客观，对于其他人来说可能好看，但这一次我感觉确实没有什么笑点，比较幼稚吧没有吸引我的地方	负面	负面
真的不好看，整了一个很大的主题，回家，弄了一个很高级的外壳，外星科技，再一次讲一个小人物大英雄故事，根本立不住	负面	负面
挺搞笑的，但是也很反应当下，中间人	正面	正面
一般般而已。。	负面	负面
好看，强力推荐	正面	正面
永远相信沈马组合，全新的场景和特效真的是很用心。沈叔叔依然还是那么搞笑。有笑有哭整个影片非常好。祝愿独行月球票房大卖。支持支持	正面	正面
好看，剧情紧凑 搞笑点很多 希望有下一部	正面	正面
跟朋友一起去看的，很好看	正面	正面
结尾不喜欢 看完感觉有点小抑郁	正面	正面
不错，值得再刷	正面	正面
还行，中国式🌹	正面	正面
有笑有泪有苦有甜才是生活	正面	正面
笑点低，不咋的	负面	负面
说实话是高质量的，看之前别看影评，影响观感	正面	正面
不错不错很值得推荐	正面	正面
一般…………	正面	负面
袋鼠主演位拿捏了	正面	正面
剧情很一般……	负面	负面
好看科幻大片	正面	正面
就是一句好看	正面	正面
好看好看的电影	正面	正面
好牵强的笑点。	正面	负面
剧情想象丰富异想天开天马行空好看真挚感人至深充实	正面	正面
不摆了，非常成功！	正面	正面
好，神马组合	正面	正面
好老高包好看考六级	正面	正面
不好看没意思就几段搞笑的然后就没了	负面	负面
含腾量极高，幽默不失哲理	正面	正面
哪个黑子说含腾量10-20%的？？？明明百分百！	负面	正面
在灾难面前我们都是蝼蚁，希望不要放弃	正面	正面
幽默，感人！	正面	正面
很好看，希望出下一部，很好的喜剧片	正面	正面
地球太危险，还是回火星吧	正面	正面
没意思没意思	负面	负面
但凡是有沈、马二人的电影，好坏不问可知！个人意见！	负面	正面
一般般，没有想象中的好看。	负面	负面
一个非常有意思的软科幻喜剧爱情电影。  在月球上我只想三件事。想活着，想见你，想活着见你。这里的爱情，不是小情小爱的你侬我侬，而是并肩同行，是成全自我之中的互相欣赏。  如果《流浪地球》是介于绝望与希望之间的末日史诗，那《独行月球》就是流沙漫行之下记载爱意与希望的山水长卷。  愿希望绵绵不绝，爱意源源不断。	正面	正面
有笑点，有泪点，总体是比较正能量的，灾后重建，重试信心很重要，相互支持很重要，让人依靠很重要	正面	正面
值得 一看，剧情前面比较欢乐	正面	正面
值得一看，含腾量100%	正面	正面
腾叔叔真的很好笑，自带笑点	正面	正面
适合小孩去观看	正面	正面
不错不错搞笑	正面	正面
开头幽默搞笑挺好，笑点密集，后面有点尴尬。	负面	正面
还可以，凑合吧。	正面	正面
好看，可以二刷	正面	正面
嗯哦哦弄哦哦	正面	正面
还好吧，没想象的感觉好	正面	正面
很有深度的电影，不是简单的快乐喜剧	正面	正面
沈腾的电影基本上不会让人失望，扣这一分是因为这部电影让我笑的同时还让我有点想哭了	正面	正面
比较不错的片子，但是比我心里期待的沈腾差了点	负面	正面
挺不错的还行	正面	正面
剧情可以算上流，但不算最好	正面	正面
设定完整，特效很棒，看得出拍的很认真，但是确实没有沈腾之前主演的电影好笑了。	正面	正面
感觉还挺不错的	正面	正面
还行6434846484	负面	正面
真的狠狠的爱 欢乐与泪水同行	正面	正面
Coldplay的音乐出来那一刻开始 沈腾叔在我心中形象直接拉满	正面	正面
电影不错，就是环球港停车费太贵了！简直是黑店啊！大家不要去相城大道上的环球港观影！	正面	正面
可以可以，不错	正面	正面
好看😊值得打卡	正面	正面
好看，好笑中又带着点悲伤	正面	正面
好看好看！从一开始的搞笑到后面的感动，还有那只金刚鼠，真的令人印象深刻	正面	正面
很棒，现场笑料满满	正面	正面
好看，很好看！不错	正面	正面
很好看吧，画面很清晰	正面	正面
有笑点有汨点值得看的的影片	正面	正面
非常不错很好看	正面	正面
别问我为什么要去看，因为不上班在家太无聊了，所以才能看到这无聊低级趣味的电影。	负面	负面
进rosyXP去去呀外婆去学习呀	正面	正面
不错的，搞笑与深意并存	正面	正面
非常非常棒，沈腾和马丽的组合从来就没有让人失望过	正面	正面
垃圾片一部不值得看	负面	负面
挺搞笑！！！！	正面	正面
非常感人非常搞笑	正面	正面
笑死我了 特别好看	正面	正面
这个电影看到一半感觉很像二十多年前，有一部布鲁斯威利斯的电影，名字忘记了，就是感觉非常非常非常像！	正面	正面
超级好看特别搞笑	正面	正面
75分叭，耿不是特别好笑 ，搞笑包袱一般	负面	正面
没啥看点，垃圾片	负面	负面
名民工明明民工你	正面	正面
十分好看强推	正面	正面
不错画面做的很漂亮，科技感十足	正面	正面
好看 好看😊	正面	正面
喜欢科幻电影，结局的时候感动了	正面	正面
沈叔叔还是很搞笑，马姐变美了。	正面	正面
先笑后哭，非常不错的电影	正面	正面
很好笑、整个厅都在笑！沈马组合yyds！！！也反映了喜剧的本质是悲剧	正面	正面
演技很不错，情节也可以，该笑的情节也都很搞笑，就是不理解，你一个喜剧为什么悲情结尾，没想明白你是想让我们哭还是笑	正面	正面
很不错的片子，轻松愉快	正面	正面
看似漏洞百出实则是无厘头，笑中有泪，值得看一看	正面	正面
说实话，我觉得一般，看到最后想睡觉	正面	负面
可以去看看的，不错！	正面	正面
小孩看了非常喜欢，尤其一人一鼠特别搞笑，好看，推荐推荐推荐看看看	正面	正面
挺搞笑的，有搞笑有感动，挺高的一部影片	正面	正面
剧情很精怪 画面很好 宇宙级浪漫我感受到了 就是电影中生活中的人们让我出戏	正面	正面
就那样吧，没什么让我觉得特别有内涵的包袱，有些煽情的剧情还是有的。	正面	正面
🌟 推荐：我真的很少看电影 这个电影是朋友推荐的 看完真的觉得yyds 这个电影真的包含很多点  😊 演技：沈腾和马丽 还有几个 演技真的没话说 很容易共情  🌅 画面：这个电影惊艳到我的还有就是画面感 很强   🎉闪光点：很多意想不到的反转和惊喜   😭 哭点：这部电影有好几个片段都让我眼泪汪汪 但是突然一下又有搞笑的部分 真的就是还没来得及哭就又笑了  😂 笑点：笑点就没得说了 还是一如既往的好笑🤭	正面	正面
好看，带孩子来看都说好看，	正面	正面
结局有些意外 很感人😭	正面	正面
很赞很不错👍！	正面	正面
蛮好看的蛮好看的很震撼	正面	正面
喜欢，非常喜欢	正面	正面
不怎么评论的，对不起票价我觉得强行尬贼尬	负面	负面
笑点很多哦，很好看	正面	正面
很好看，特效很好，代入感强，很欢乐，全程没出戏	正面	正面
可以，总是在不经意的时候让你笑	正面	正面
很好，有笑有泪	正面	正面
超级搞笑，最后挺感人的	正面	正面
非常喜欢很有意义的电影🎬！	正面	正面
好看啊…………	正面	正面
强烈推荐，喜剧，感动	正面	正面
总体感觉一般，太过煽情，有点无聊	负面	负面
还行，可以看看，当放松。	正面	正面
好看极力推荐	正面	正面
很好看，强推！最后主题升华，哭死了。	正面	正面
沈腾马丽就是可以	正面	正面
和朋友一起看的，很有意思	正面	正面
好看又好笑又感动	正面	正面
剧情一般般，	正面	负面
非常好看👍👍	正面	正面
有笑有泪，沈马组合yyds.	正面	正面
很有沈马的风格，笑中也带有深意，值得一看。	正面	正面
很好看，剧情也很好	正面	正面
看的想睡觉，演技可以，剧情……怎么这还能拍成电影，导演的思维拍成这样不太理解，反正挺烧钱的😂	负面	负面
挺好看的，孩子很喜欢看的很开心	正面	正面
沈腾与一只袋鼠主演，非常值得观看	正面	正面
做人还是要有希望有信念，自立自强！	正面	正面
强烈推荐，特别好看，很搞笑也感动	正面	正面
好看，但又没那么好看。	负面	正面
很好看，轻松搞笑，本来是去看沈腾马丽，结果被刚子感动了！	正面	正面
好看好看 太好笑了	正面	正面
垃圾片，喜剧不像喜剧，科幻不像科幻	负面	负面
有笑有泪，特效还特别棒！太赞了！！	正面	正面
太没意思了，和之前的差太多啦	负面	负面
好，珍惜身边人	正面	正面
剧情一般，没有想象中的那么好	正面	负面
背负着重振电影市场的重任，电影没有让人失望，票房火爆，上座爆棚。 这次开心麻花还邀请了笑果脱口秀团队加入，文本可见升级，很多梗都能看出脱口秀的技巧。前笑点十足，后哭点感人，教科书般的高级喜剧。 沈腾马丽组合依旧yyds,影片特效也很棒，特别是有Cgs中国巨幕效果加持，更为震撼!	正面	正面
非常好看，超级超级好看	正面	正面
剧情还是非常不错，值得推荐。	正面	正面
太好看了好嘛!!这对搭档从不让人失望!	正面	正面
演技真的非常好	正面	正面
大烂片，看不懂剧情，全靠人凑	负面	负面
也太烂了吧，不好看	负面	负面
很值得一看，笑着开场哭着结束，沈腾马丽从不会让人失望	正面	正面
好好的，我们的话说，	正面	正面
好看感人又好笑	正面	正面
前面搞笑 后面感动 结局悲伤 挺励志的吧	正面	正面
可以。很好笑	正面	正面
偷票的垃圾 票房都是虚的 **	负面	负面
不怎样……普通	负面	负面
是真的不错 前面非常好看 值回票价	正面	正面
看之前没想到这么催泪555555	正面	正面
沈马组合yyds	正面	正面
挺好看的，剧情跌宕起伏	正面	正面
挺逗的，很好看	正面	正面
不知道放了一些啥 搞笑是蛮搞笑的 没评论区说的这么夸张?反正没被惊艳到吧！	负面	正面
喜欢养宠物的去看看	正面	正面
挺好看的，经典搭档，笑中有泪，意义升华	正面	正面
不错，剧情也很好	正面	正面
既感人，笑点也多	正面	正面
很不错哦！带孩子去看的，在电影院笑得直不起腰。沈腾出演的电影还是值得相信的，推荐！	正面	正面
一级棒一级棒！！	正面	正面
特别喜欢沈腾马丽的电影，有笑有泪，真心不错，值得推荐，绝对不会失望。	正面	正面
电影可以，电影院太差劲了	正面	正面
小朋友很喜欢。	正面	正面
超级好看！还得去看一次	正面	正面
内容丰富，主题深刻	正面	正面
就是一个字，好看！	正面	正面
特别喜欢特别好看特别棒	正面	正面
腾意满满，但还是觉得煽情大于搞笑，“骗”得眼泪💧多多～	正面	正面
好看，灰常好看！！！笑中有泪！	正面	正面
很不错，含腾量百分百	正面	正面
非常好看，超乎想象	正面	正面
蛮好看的，搞笑加感人	正面	正面
开心麻花必出精品 😭 整部电影下来独孤月和马兰星的爱情非常感人，独孤月就是大英雄 👏	正面	正面
很喜剧，也很科幻，还行，还是开心麻花的风格，我感觉主要还是搞笑。	正面	正面
喜欢沈腾，无条件满分，剧情演技在线，感动更多。	正面	正面
好看，不错，	正面	正面
超级不好看。。整部剧觉得很无聊 好评都是刷的吧	负面	负面
剧情挺搞笑的	正面	正面
有笑有泪，感觉还可以。亮点主要是沈马组合，剧情一般，感觉和流浪地球比较相似。	正面	正面
前段高效，后段感人。挺好看的	正面	正面
跟以前没有办法比了不高兴了	负面	负面
非常好看，二刷完了！！！沈马就是最棒的！！！独行月球冲啊！！	正面	正面
剧情真的很好，沈腾有几个镜头依稀可看到小草的影子。马丽竟然也让人觉得很漂亮。	正面	正面
有点强行煽情 但确实挺搞笑的	正面	正面
含腾量满级 必须推荐	正面	正面
真的好好看 后边也感人	正面	正面
看了一半出来了，怀孕八个月不易去看电影啊，	负面	正面
一般吧，有点强行搞笑	正面	负面
前十分钟的运镜绝了，鸡皮疙瘩飞起 ​特效全程在线 ​还有，我永远都吃开心麻花的笑点和泪点！	正面	正面
太搞笑了，不错	正面	正面
蛮好看的，喜欢	正面	正面
很感动，喜欢沈腾马丽	正面	正面
值得一看，还可以。	正面	正面
又爆笑又感动	正面	正面
感人，但男主对感情付出的太多了，付出了生命的代价是不值得。	正面	正面
挺好探店之后赶紧来评论，服务员反应很及时，环境颜值在线，整个过程都很愉快	正面	正面
年度最佳，太酷了	正面	正面
还可以故事很感人	正面	正面
还可以吧。孩子看的挺开心。结局有点可惜。	负面	正面
明摆着是沈腾独角戏啊！莫名其妙的多了个破袋鼠🦘！还不如把袋鼠换成马丽呢！不知道导演咋想的	负面	负面
如果可以的话，半颗星都不想给，明显就是来骗钱的呀。什么乱七八糟的，一点诚意都没有，一路看沈腾的电影过来的，这部电影是怎么了呢，现在就剩用自己的人气来骗钱的地步了吗	负面	负面
挺好笑的还算	正面	正面
感觉一般般，没有什么亮点。	负面	负面
挺搞笑的，大人小孩都喜欢看	正面	正面
爆炸好看，看哭了	正面	正面
没得说 喜剧 又带有一丝悲哀 演绎的淋漓尽致 看的人笑的那叫一个爽	正面	正面
真心一般，傻子演	负面	负面
没有想象中的那么好看	正面	正面
作为喜剧还阔以，不能当科幻来看	正面	正面
意料之中，情理之内。开心麻花正常输出。值得一看。	正面	正面
好好看 好搞笑	正面	正面
好不错！！！	正面	正面
全场主角只有沈腾和金刚鼠	正面	正面
很感动的一部电影	正面	正面
非常喜欢，好看好看，希望继续努力出	正面	正面
沈腾这么多年了 拍电影的风格还是跟几年前一样的拍戏风格一样。要不了几年应该就要凉了	负面	正面
剧情有点像流浪地球，搞笑程度也少了，正经起来的沈腾，感觉还是差点那啥，说不上来	正面	正面
非常好看，剧情紧凑，超棒	正面	正面
嗯，给7分是因为让我笑了几下，其他真无聊	正面	负面
是体验最好的一家店了，氛围很好，让人感觉很舒服😁	正面	正面
马丽和沈腾的演技真的一绝	正面	正面
还可以的能看	正面	正面
现在的喜剧是怎么，为什么都是喜头悲尾呢！	正面	正面
看着搞笑有意思	正面	正面
很好看呀，剧情特效都很好	正面	正面
挺不错的666	正面	正面
开头比较搞笑，后面蛮感人的	正面	正面
剧情大的框架没说的，但是小的包袱略显乏味，因为，没了悬念，包袱见头知尾。 刚开场，看到史彭元的戏份，还以为是在《隐秘的角落》之前拍的呢。 黄子韬版的“黑皮”口音，挺好。 但是不少对白都是抠了原声重新配音，也是现状，没什么挑的。	正面	正面
总体很好，很有创意	正面	正面
🌟 推荐   真的很好看！！	正面	正面
依旧支持沈叔叔	正面	正面
一般，但比近期的要好看。	正面	正面
很不错，环境也好	正面	正面
特效堪比美国大片，国产巅峰，笑点沈腾从不让我们失望，感人的地方，震撼无比，所有人超长演技。只能10分不能再多了，又一部含腾量百分百的神作！	正面	正面
不好看啊，笑点很低，我不知道为啥评分那么高。小孩子看看还行吧，剧情也很无聊，感觉有点抄袭国外的一部月球xx。	负面	负面
很好看，形容不了的好看	正面	正面
看个人喜欢吧	负面	正面
好看 好笑 nice	正面	正面
我觉得挺好看的，有喜有悲，人生不就是这样么！	正面	正面
非常好的电影，内容和演员都让人很开心	正面	正面
还行 期待挺高 笑点还是挺多的	正面	正面
又搞笑又感人，点赞，值得去影院一趟	正面	正面
好看😊 真的好看	正面	正面
挺好的，挺好的	正面	正面
太棒了！！！	正面	正面
居然喜剧能和科幻相结合，值得一看的电影	正面	正面
一般般吧！挺搞笑的	正面	正面
一般，期望很高，但是很失望，全程我没笑，结尾也一般	负面	负面
感觉太棒了，笑点很高	正面	正面
太喜欢沈腾马丽了	正面	正面
很好笑，很感动	正面	正面
好看，电影不管是取材还是拍摄一级演员表现都棒，希望电影票房可以冲顶！加油！	正面	正面
还行吧 可惜最后	正面	正面
很好看 励志且感人	正面	正面
真的超级好笑 不愧是沈腾他们主演的  后面真的哭的稀里哗啦  又搞笑又好哭  超级棒  幸好没有错过  期待沈腾再出新的作品	正面	正面
算是及格吧，两个小时的时长并没有觉得特别不舒服的地方，只是袋鼠太人性化，有点尬	负面	负面
太一般了 失望	正面	负面
挺好的  我们几个人一块看都觉得蛮不错的	正面	正面
看过之后，大失所望	负面	负面
太好看了，爱沈腾	正面	正面
还不错，还挺感人的	正面	正面
独孤月和金刚鼠这对CP，针不戳	正面	正面
不错 一场宇宙级的爱情 一个悲伤的故事	正面	正面
棒棒哒，值得观看	正面	正面
搞笑路线的电影，但最后居然悲剧收尾，我不理解	正面	正面
搞笑的地方还不错，其他真没质量，浮夸，	负面	正面
你可以永远相信沈腾和马丽👍🏻👍🏻👍🏻	正面	正面
好！好看！推荐！	正面	正面
剧情不错 喜又感人	正面	正面
看得我想睡觉！一点也不好看	负面	负面
含腾量就知道片子好不好看，好不好笑了	正面	正面
好剧！推荐！	正面	正面
好看，不错，多出点这种影片	正面	正面
不知道看了什么	负面	正面
谐星谐星，搞笑科幻带着一点励志，励志中不乏幽默，愉悦身心	正面	正面
好好看。。。。	正面	正面
还不错，含腾量99	正面	正面
太好看了！！！本人没文化，我只能说沈腾马丽永远的神！！！	正面	正面
好看的推荐喜欢的	正面	正面
马丽好美马丽好美	正面	正面
还可以，可以一看	正面	正面
非常好看又搞笑	正面	正面
好看，特别好看，特别值得看看	正面	正面
儿子说还不错，比之前的黄渤演的莫扎特好看许多。还是挺搞笑的。不过坐在我们前面的孩子一直哭，说不要沈腾S 孩子以为他要S在月球上了。好多大人带孩子去看 这部电影票房肯定不会低。	正面	正面
结局有点伤感，还行吧，可能我预期值太高了	正面	正面
剧情还可以 ，平淡中带点搞笑 又有一点煽情 ，可以看一看 ，但是也没有说特别特别出圈的那种出彩 ，期望值不要放的特别高 看看还是不错的	正面	正面
冲着沈腾来看的，果然没令我失望	正面	正面
电影其实很不错， 服务超级差！！！ 服务员一副爱答不理的样子。	负面	负面
剧情真的很尴尬我真的不懂为什么这么多人吹这个电影	负面	负面
这是唯一一部我没看完弃了的电影。笑点有点，没什么主题和立意。多的不说了。	负面	负面
很好 值得看	正面	正面
挺好看的很喜欢看沈腾和马丽👍	正面	正面
什么垃圾东西浪费时间	负面	负面
还可以！不错	正面	正面
电影其实还可以，前期都是笑点，但是就感觉前期好看一点，后面比较无聊，剧情都猜到了，而且不知道为什么，感觉马丽从一念天堂开始，只要一正经起来，就会有一种比较别扭的感觉，电影总体还是不错的，可以看看	正面	正面
一句话，两个字:好看	正面	正面
还行，一般好看	正面	正面
真的好看。搞笑中带着悲伤 结局完全是我没想到的	正面	正面
不错！ 🎉闪光点	正面	正面
前面一个小时剧情很棒，最后沈腾扛着核弹去炸陨石，技术上稍微有点扯，用喜剧方式整的不伦不类的魔幻结局。	负面	正面
还得是沈腾啊，有笑有泪，期待二刷	正面	正面
还不错，虽然结局有点不是很戳我	正面	正面
必须给十分，一直很喜欢沈叔叔，马丽姐，这个电影依旧让人期待➕期待值百分百，有泪有笑，氛围细节拉满，必须满分	正面	正面
剧情还行，还是值得一看的！	正面	正面
换是蛮搞笑的	正面	正面
就这？这拍的都是啥？好笑吗？完全不 冲着这班人马去的 结果直接无聊到让人睡着 太失望了 摊手	负面	负面
特效没的说，太喜欢沈腾了	正面	正面
嘎嘎嘎嘎好看 🌟 推荐	正面	正面
我觉得这个电影很考验一个演员，我不懂哈，只是个人见解，一个人，一只袋鼠，一个摄影棚，没有对手搭戏，全屏剧本或者演员个人经验和现场发挥，能演成这样，我觉得对于一个演员个人经验来说已经想当可以了。沈马搭档的电影，基本不会让人失望，还有各路开心麻花的大神们搭档，值得一看。	正面	正面
这部电影剧情不错、画面很好、并且让人觉得很感动，这部电影也展现出来了英雄的形象。不过其中还有笑话，建议大家多看看。	正面	正面
还不错 就是有些地方略显尴尬	正面	正面
剧情一般，凑合	负面	正面
开头有多开心，结局就有多伤心！	正面	正面
非常好看，娃娃很喜欢，感动的哭了几次。	正面	正面
有搞笑又励志	正面	正面
前面有笑点  后面也会有泪点  对于我这种泪点低的看了就会   真的很推荐 🌟 推荐	正面	正面
感觉沈腾有点技穷了说实话	正面	正面
太好看了，开头开头搞笑，后面感人，看到最后好多人都哭了，我强忍住没哭	正面	正面
好看，刚开始一路喜剧，到快结尾时太感人了。值得推荐。	正面	正面
非常好看，很搞笑	正面	正面
又哭又笑，剧情很紧凑	正面	正面
这么打动我的喜剧 太难得了	正面	正面
这部剧非常满意，值得看	正面	正面
不好看科幻不科幻笑料很少	负面	负面
电影很好看，很不错	正面	正面
有笑有泪，宇宙繁星，人类并不孤单，地球人加油！	正面	正面
很好看！沈腾马丽依然很好，没失望	正面	正面
好看的 很感人	正面	正面
前面搞笑 结尾煽情 剧情比较老套但好看 主题比较好，歌颂英雄的 还是值得一看的	正面	正面
好看，相当推荐，非常优秀的合家欢喜剧。有笑点有泪点，前期节奏有点紧，但总体而言相当值得一看	正面	正面
有笑点有泪点 喜剧的内核是悲剧	正面	正面
挺好的，很喜欢，很满意。	正面	正面
完美，情节紧凑，幽默诙谐	正面	正面
剧情无聊，这是喜剧？都快睡着了，千万别看，真是不值一文啊	负面	负面
一般水平，哈哈哈哈	负面	正面
来了这么多次没有踩过雷，非常不错，想来的可以冲了，电影故事情节一般	负面	正面
可以，挺好的	正面	正面
很感人.沈腾的电影现在越来越有意义了	正面	正面
可以可以了了	正面	正面
非常不错值得推荐观看	正面	正面
很不错、还会继续回购	正面	正面
挺好 非常不错	正面	正面
挺好看，虽然不是那种纯纯的喜剧！	正面	正面
不错不错，挺好看的	正面	正面
剧情一般，每个剧情都能猜到	正面	正面
好看，太好看了	正面	正面
值得一看，画面感很好	正面	正面
结局拉胯啊啊	正面	正面
很好看～开心麻花没让人失望	正面	正面
不错😊孩子看完很开心	正面	正面
挺好看的，笑点太多了，虽然最后有点煽情！	正面	正面
非常好看，加油💪	正面	正面
又搞笑又感人 后面直接哭死	正面	正面
好看呢，挺搞笑的	正面	正面
挺好看的，推荐。	正面	正面
挺不错的，画质也蛮好的	正面	正面
我觉得还行，科幻喜剧片，沈叔叔一如既往的搞笑天赋在线，有开心，有温情，我挺喜欢的。	正面	正面
沈腾包揽了我这几年的影视笑点，这回都折腾到月亮上了！！ 致敬所有为人类不断开拓的宇航科学家们！	正面	正面
可以一看，ost很好听	正面	正面
好看的，挺搞笑。	正面	正面
前边挺搞笑的，后边的伤感也行	正面	正面
特效一流，沈腾演技精彩，配角演技也在线。 可以说除了不好笑，其他哪都好。 但我看喜剧片就是为了笑啊，无奈了。	负面	正面
一般！不推荐看	负面	负面
演技都很好，剧情尴尬，笑点也尴尬	负面	负面
非常好看！！推荐	正面	正面
挺感人的	正面	正面
好看。好笑。	正面	正面
很好看，一开始是搞笑，后面有点感人	正面	正面
开心麻花的电影果然不会让人失望，让人开心快乐是多么的难得 🌟 推荐	正面	正面
好看好看，超级好看	正面	正面
很好玩，可是结局不太理想。	正面	正面
暑期终于等到一部好看的电影了	正面	正面
笑着笑着就哭了，沈马的be永远的意难平	正面	正面
真的很好看！！🥹🥹🥰🥰啊啊啊啊啊哈哈感人又好看	正面	正面
轻松，感人，可爱	正面	正面
是真好！值得看	正面	正面
非常不错，喜欢沈腾和马丽。	正面	正面
挺不错的 值得看	正面	正面
特别喜欢老逗了	正面	正面
挺搞笑的，特别喜欢沈腾跟马丽	正面	正面
还可以吧，就没有很好，也没有不好。	正面	正面
非常好看的剧情	正面	正面
还可以，期望值太高了😿	正面	正面
虽然是很多不合理的软科幻喜剧，但重点是喜剧就够了，含腾量足够就好！ 剧中致敬了很多电影，有国外的，也有国内的，细品！	正面	正面
电影很不错，值得推荐。	正面	正面
很好看真的好看	正面	正面
非常满意，中国科幻的前沿，未来可期的电影发展方向，喜剧与科幻融合的典范，充满期待和敬重，大腕云集，满场笑点，大人小孩皆宜的一部科幻喜剧片，赞👍🏻	正面	正面
挺不错的 好看	正面	正面
挺好看的 搞笑也感人	正面	正面
画面很震撼!	正面	正面
剧情感觉每一个镜头的衔接，包括袋鼠的出现感觉都非常牵强，剧情上实在是差太远，不是沈腾的包袱；和沈腾演技的功力在这里顶住，这个片绝对算得上是烂片。不过有了沈腾的加持也只能给一个中评，绝对算不上好片，感觉今年的电影一次又一次的让人失望，没有好片出来啊	负面	负面
值得推荐 好看 搞笑	正面	正面
电影很好看的	正面	正面
好极了很好看的	正面	正面
极限的浪漫，送给宇宙，送给爱情，也送给普通的自己。虽然没有爆笑爆哭，但节奏氛围把握的挺好，足够商业。看得出导演的小心思和全局感，是个聪明人，不然也不会这么快拿下韩国大IP，想做点不一样又有商业性的。一定有人喜欢有人不相信很不喜欢。带我回家，没有鸡汤文学，就挺好！	正面	正面
好看的，特效、笑点、剧情都挺好，就是部分煽情的点有小尬，算是今年电影中的佼佼者了	正面	正面
挺好看的，笑点也挺多	正面	正面
还可以吧 就还行	正面	正面
非常棒 一部有创意的电影🎬力作	正面	正面
环境非常一般，态度也一般，没人看的影院	负面	负面
只能说是还可以 没有想象中的惊艳 所以金刚鼠这个角色的刻画有些过于丰富	正面	正面
剧情很棒，很吸引人	正面	正面
还行吧  前面搞笑  后面煽情	正面	正面
真的很逗，也真的很好哭	正面	正面
非常好看的一部电影，真的会让你大哭大小痛痛快快的感受一回主人公身上的大爱和小爱，就是最后的结局有点让人意难平，心里很不舒服。当然生活永远都不可能完美，就像电影一样才会让人记忆特别深刻。沈腾马丽永远是最棒的组合，永远不会让你失望，相信我这部电影绝对值得你走进电影院。	正面	正面
沈腾马丽从来没有让观众失望过，这次金刚鼠太棒了	正面	正面
。还可以。。	正面	正面
故事很好，只是结局有些小悲伤	正面	正面
很搞笑 很好看	正面	正面
剧情还好  前半段搞笑  后半段就那样 没有明日战记好看个人感觉	正面	正面
优点：特效很好，前期笑点多 缺点：后期有点严肃了，没什么笑点，我受够喜剧电影搞煽情了，这也能高分？反正往下拉个评分也改变不了什么	负面	正面
不负期待，一会哭一会笑。含滕量挺高。只要不从科学性的角度去评价，这是部接近完美的科幻片。 论表现，独孤月和刚子不分伯仲。其他角色都平平。黄子韬不画眼线而且说青岛话的时候还是挺爷们的……把独孤月的肉身和灵魂留在太空里，属实让人感觉有点悲怆。 果然，书也好 漫画也好，看不进去的时候，靠电影来演绎就不一样了。	正面	正面
挺好的，就是结局有点。。。	正面	正面
挺好的   轻松诙谐又有点感人 好演员搭配好作品 我们喜欢看	正面	正面
没意思！看睡着了	负面	负面
🌅 画面 有笑有泪，很赞	正面	正面
🌟 推荐 国庆假期带孩子全家去看的，平时的工作学习太多压力，看看喜剧片释放下挺好的，也喜欢沈腾的表演，骨子里的幽默，全程搞笑不断，也很感人-普通人的情感，放到全人类的高度也许本就是一个笑话，人生如戏，只为一乐，推荐想放松心情的朋友去看看	正面	正面
以为是个喜剧结果给我哭的….	正面	正面
有些小笑点可以的	正面	正面
好看，很好看啦，好好看	正面	正面
沈腾是我最爱的演员，电影也没让人失望。这部太好看，一边搞笑一边感人。棒棒的。	正面	正面
真的挺好看的，期待下一部	正面	正面
挺好看的 前面有多搞笑后面就有多悲剧 并没有强行煽情	正面	正面
还可以，含腾量很高	正面	正面
啦啊飞过了分开咯哦模棱两可	正面	正面
还行吧 没有很突出	正面	正面
太难看了…中国观众喜欢您 不至于就乱拍吧……忽悠中国观众 就算含腾量高就乱来 确实不能买账！	负面	负面
你可以永远相信沈马组合！麻花的剧很少让人哭的 、同时笑点也是很足、很棒的一部剧	正面	正面
只要有沈腾就满分	正面	正面
前面挺搞笑的，中间夹杂着温情，爱情，提现中国人的团结，智慧，和坚持!总之很好看!刚子是YYDS。全程萌萌哒~	正面	正面
嗯嗯好好好好	正面	正面
导演不知道是谁，好多场景氛围感总是差那一脚。解说片段过多。整体还行	正面	正面
即墨区忘记咯	正面	正面
强力推荐，中国式科幻喜剧	正面	正面
太好看了呜呜呜呜笑点足 泪点爆了好嘛 都给我去看呜呜呜	正面	正面
好看好看，强烈推荐	正面	正面
非常好看，不光有笑点，也有泪点，个人觉得刚子拉车那段是全剧的高潮点。。刚子拉着腾哥飞过万千星辉的那一刻:否极泰来的刺激和喜悦，在宇宙里驾着袋鼠的荒诞，特效打造的寂寂黑夜里的万千星辉。是那么纯粹的浪漫。这一段配上酷玩乐队的歌也是天衣无缝	正面	正面
挺好，去看看吧	正面	正面
好看感人浪漫	正面	正面
含腾量100你可以永远相信开心麻花	正面	正面
好看，特精彩	正面	正面
80分吧，还是可以一看！	正面	正面
。嗯嗯嗯 很好	正面	正面
腾味十足 笑中有泪 开心麻花yyds 真不错！	正面	正面
没有原来开心麻花的片子好看了	正面	负面
好看 推荐大家观看 很有看点 既好笑又感动	正面	正面
哈哈哈哈哈哈哈哈哈哈哈累额经纬就是静静时间	正面	正面
沈腾和马丽联手绝对不会让人失望。 真的是太太太太好看了！ 泪点和笑点并存，对人性的弱点和坚强都剖析的十分透彻，真的是超级超级棒的一部电影，一定要看！错过就太遗憾了！！！	正面	正面
一贯开心麻花的作风，作品精品，笑点多	正面	正面
还好，跟之前的没法比，没有那么多的笑点，可能走的路线不一样吧	正面	正面
剧情不错，情节感染而幽默	正面	正面
观看的只有三个人，也挺好	正面	正面
剧情一般，强行煽情了	负面	负面
电影特别好特别搞笑！	正面	正面
很感人，前面很好笑，后面哭的猝不及防😭	正面	正面
人间的真话本来不多，一个女子的脸红胜过一大片话——老舍《骆驼祥子》	正面	正面
我觉得一般般，都看睡着了。😆	负面	负面
太坑了，好无聊的剧情	负面	负面
反正也没更好看的，看看也无所谓	正面	正面
不好看 笑点少	负面	负面
好搞笑。。。	正面	正面
又搞笑又很感动	正面	正面
不错。超级棒	正面	正面
前半段搞笑，后半段感动，是一部非常好的电影，演员演技在线，剧情也好，真的是一部非常值得一看的电影 推荐推荐推荐	正面	正面
还可以，感人	正面	正面
还行，很好笑，诙谐幽默	正面	正面
很搞笑又很温情	正面	正面
都非常好！特别棒	正面	正面
真心推荐 去看。有笑的合不拢嘴 有让你哭的彻底	正面	正面
还可以的 剧情也还不错	正面	正面
有泪有笑，结尾感人，算是开心麻花团队最好的一部电影了	正面	正面
最终豆瓣评分不会超过6分，喜剧开心麻花一家独大也不是什么好事	负面	正面
真的太失望了，很尬的一部剧情，笑点也很老套，沈腾马丽的组合实在是越来越差强人意了	负面	负面
真的很好看 也会有泪点 真的就是含腾量满分！ 🌅 画面 画面也很美 反正就是强力推荐	正面	正面
挺好看的 好看到出乎意料 最后没想到的是竟然是个be美学 强烈推荐！	正面	正面
这么难看 不知道为啥这么高分	负面	负面
非常好看哈哈哈	正面	正面
没事看看还可以！	正面	正面
没有期望就没有失望，我想大多数人都是冲着沈腾和马丽去的，但是这部电影如此高的评分我着实感觉“德不配位”，不搞笑无逻辑很无聊，硬撑着看完整部电影，腰酸背痛，如果你有情怀，那我奉劝您带着情怀就好，不要有过高期待，否则失望的就是你；最后让我们一起期望沈腾和马丽下一部电影会有所突破。	负面	正面
真的超级好看！ 🌅 画面绝美，真的推荐大家去看，并不是普普通通的喜剧！！	正面	正面
沈腾的作品总是很有质量	正面	正面
非常不错，很好	正面	正面
还可以，挺搞笑的。	正面	正面
沈腾的电影真的有 一直都好看	正面	正面
很感人   感人	正面	正面
感觉像是欧亨利式的结尾。结局不落俗套，一下就戳中我这个be美学爱好者的心巴。	正面	正面
还蛮不错的   太搞笑了	正面	正面
挺好看的呢！	正面	正面
特效挺不错了，含腾量百分百，哈	正面	正面
😭 哭点 这种舍己为人的情感诠释的很好，包括人与动物之间生死之间生死选择，也体现出了人性的温暖，很好，强烈推荐在影院观看，氛围非常的棒。	正面	正面
太垃圾了，想赚钱不至于这样吧？	负面	负面
这破手机潇洒你这不肮脏色可啥意思呀咯体重破定制呀lienso ku	正面	正面
特别好看，搞笑。情节紧凑。推荐	正面	正面
从开始笑得肚子疼 到后面讲不出话 从我认知的搞笑片到发现这是一部悲剧片 独孤月不完全就是一个被薅羊毛最后一根毛都剩不下的人吗 从小没有家人没有朋友 特别孤独 到遇见马蓝星成为他生命里的光 他用自己点起全球所有人对生的希望 到最后要返回地球时拯救地球 除了马蓝星没有人在记得他 袋鼠成了英雄	正面	正面
不错很棒鹅鹅鹅	正面	正面
非常好看，我很喜欢！	正面	正面
果然    开心麻花没让人失望	正面	正面
真的好好看，那句马蓝星带我回家，爆哭	正面	正面
值得一看，非常不错。	正面	正面
今天的快乐是刚子给的 今天的难过是独孤月和马蓝星给的 好看 推荐！😣	正面	正面
电影院不行，	负面	负面
都说挺好 过来看看	正面	正面
挺搞笑感人的 笑着笑着就哭了	正面	正面
**  真**	负面	负面
挺搞笑的，，含腾量十足	正面	正面
有哭有笑还不错	正面	正面
没有之前夏洛特烦恼和西红柿首富两部好看，但无聊的话还是可以看看	正面	正面
原来爱很简单！只是这个爱是独孤月和刚子的爱！	正面	正面
特别好好看的	正面	正面
真的很好看 挺感动的	正面	正面
挺好看的剧情	正面	正面
很好看，不错哦	正面	正面
强行为了几个段子凑出来一部电影，各种老梗套用，玩尬的，后半段全无笑点，不推荐	负面	负面
很好看的电影，支持沈腾	正面	正面
还不错吧 主要是搞笑片 科学性的话可能没那么严谨 搞笑是很搞笑	正面	正面
冲着这含腾量，也得顶上来，有爆笑，有温情，捧腹的同时，也能潸然泪下。剧情完整，连插曲都让人回味无穷，能看的出来，歌词很用心。懂喜剧的人，把控一部喜剧，一定是好片子。里面的梗估计看过的人都懂。他俩的CP大旗，连正主都嗑，我们还有啥理由不喜欢！	正面	正面
真不知道评分怎么来的，看的没点意思，垃圾电影	负面	负面
剧情没有想象的好，笑点也一般，可能是期望值太高了。	正面	负面
结局不太好，还不错	正面	正面
金刚鼠是笑点所在，增加内容丰富性的	正面	正面
宇宙那么大，我会肯定会相遇的。 电影很好看，在搞笑的同时也很感人。值得一看	正面	正面
作为喜剧还行	正面	正面
还不错👍赞	正面	正面
宇宙那么大，我们还会遇见	正面	正面
好看，喜欢沈腾	正面	正面
真的很不错  上半场笑着哭  下半场哭着笑	正面	正面
放下脑子来看吧。。。但凡带一点脑子都会觉得一个不合理接着一个不合理。。。	负面	负面
3分不能再多了，剧情混乱垃圾，	负面	负面
剧情不错，画面还行	正面	正面
看了一半，有笑有泪！	正面	正面
跟朋友看的 挺好看	正面	正面
笑点不多，而且很多是强加的，至于有人说的感人，完全没感觉，就是一部看特效的科幻片。	负面	负面
非常棒！一级棒！	正面	正面
不错。挺好看	正面	正面
拍出个四不像	负面	负面
不错 有喜有悲	正面	正面
九分吧，他吃硬不吃软	正面	正面
相当棒了，非常好看	正面	正面
剧情跌宕起伏，音响效果好，沈腾演的独孤月从开始的自暴自弃到后面成长为真正振救地球的英雄，人物内心戏表演到位，催人泪下，值得推荐的一部好剧！	正面	正面
不错 很多笑点	正面	正面
演技可以，就是不整么震撼。算不上大片	负面	正面
前面非常搞笑，但是后面非常感动 。	正面	正面
整个画面还是很不错的	正面	正面
电影好看，很好笑，又很感动	正面	正面
很好看，比明日战记的剧情好太多了，有笑点有泪点，很值得一看👍🏻👍🏻	正面	正面
好看，喜欢沈腾和马丽	正面	正面
不错的，BUG挺多，但不影响剧情与喜剧效果。开心麻花团队的作品还是值得一刷	正面	正面
搞笑中带着感动，还是强烈推荐的	正面	正面
剧情好极了，很棒	正面	正面
失望至极…… 全程没笑过甚至想快进	负面	负面
挺好不错喜欢	正面	正面
剧情很搞笑，画面清晰，	正面	正面
体验了一把哭笑不得，刚有点泪，下个镜头就笑死，反正值得一看，好看含腾量真的很高	正面	正面
我想打90分，因为满分是150，剧情看到后面有点拖沓，强行的煽情，一个小时时间想睡觉	负面	负面
还不错，有点看头	正面	正面
不好看！！！	负面	负面
真的很不错的一部片子，中间很搞笑，想法也是蛮新颖的，就是可惜独孤月最后牺牲了	正面	正面
不错挺好看，最后很感人	正面	正面
还好吧但是有点抄袭	正面	正面
还可以吧挺好看的	正面	正面
很好看，想要二刷的程度	正面	正面
沈马yyds！！！真的很好看、有笑点有泪点，结局给我的感觉就是喜剧的内核是悲剧，be美学的魅力！！	正面	正面
还是很不错，带孩子看	正面	正面
因为看了赵石的原漫画，所以对电影期待值爆表，但是一些剧情的改变，会消失一些笑点 与此同时，腾哥自带的笑点让人惊喜，可以看得出超级用心！	正面	正面
特效真的算国产顶级啦 虽然有些部分能看出来袋鼠是人扮的 而且有些部分人物口型台词对不上 总体来说真的不错 一部完整的逻辑清晰的、 合格的科幻喜剧爆米花电影	正面	正面
画面流畅、清晰、很有质感，剧情幽默、励志、感人，值得观看	正面	正面
好好看！！想二刷了	正面	正面
好看，孩子看了两遍	正面	正面
一般般，没什么出彩的地方	负面	负面
沈腾马丽合作好，月球厉害	正面	正面
作为科幻片都不够入门级别的，喜剧片勉勉强强，就像个大型小品一样，台词都是浅显炒冷饭、刷老梗，整部片子像肥皂剧一样，看了，你问我看了什么我能告诉你大概剧情，你要是问我有什么印象深刻的场景或台词，对不起，没有，没有那种直击脑门的场面和台词。自从李焕英以后只要是稍微有点背景的影片，那个评分就高的离谱，名不副实。现在独行月球9.3，和复仇者联盟这些就差一点点，甚至还有一大部分不如它，费解。	负面	负面
还是蛮感人的	正面	正面
搞笑又感动😹	正面	正面
是真的不好看，谁看谁知道，不知道这么高的分是哪来的	负面	负面
---20220816『独行月球』🌘  🎟️​“宇宙那么大，我们还会遇见”。浩瀚星河，群星闪耀。星光所及之处，便有人仰望星空。缘起缘灭，是命定，亦是轮回。 🎟️​上映正赶上成华封区，等到解封了，应疫情管控附近还没一家电影院开门，等附近电影院陆续开门了，成都高温橙色预警，想看又不想出门被热死，可纠结死人☹️然而收到好多安利，终于忍不住，还是在35℃的夜晚去影院补上了 🎟️​沈马时隔七年的又一长片，依旧是满满的默契🤩意想不到的包袱抖得够响，一人一鼠的爱恨情仇也狠狠感动！有笑有泪，是纯纯的开心麻花味啊！btw太空部分的画风构图我可是太爱了！	正面	正面
可以看，可以看而已！	正面	正面
演技杠杠滴👍👍👍	正面	正面
不错的，就是有点辣，不过还是很好吃的。不错的，挺好吃的，就是量有点少。	正面	正面
好看，有笑点有泪点	正面	正面
挺好的 值得一看	正面	正面
好看，有哭有笑，情节也很好看，推荐👍👍👍	正面	正面
生命的意义是什么？是活着，是爱所爱的人，是奉献和牺牲。沈腾诙谐幽默的传递了生命的意义，笑着笑着就哭了	正面	正面
结尾的牺牲太狗血了，耐不住腾哥的哭戏实在真挚感人，希望高能游戏快点上映	正面	正面
腾哥出品 必是精品	正面	正面
不知道怎么说，只能说是我心中的第一	正面	正面
🌟 推荐不错很好看。	正面	正面
二刷了还是被笑哭🤣戳我泪点又戳我笑点的	正面	正面
可以看，不是最好	正面	正面
组合没让人失望过	正面	正面
没想到黄子韬愿意丢掉偶像包袱，原因扮丑愿意当配角 。不过黄子韬的确很帅，穿的破破烂烂也很帅	正面	正面
不吹不黑，的评价一下，故事架构，剧情及演技，三点简单说一下  1，故事架构和流浪地球的框架一样，因为地球受到了危难，在月亮上开启了防御地球计划，也是一个孤独英雄和地面团队合作，开展拯救计划，可是因为要有英雄所以必须有牺牲，个人觉得整个故事框架吃鱼导演还是有copy流浪地球的嫌疑，虽然影片也说了流浪地球和吴京  2，剧情整体流畅，但是安排了一些类似于李亦儒掉登的梗，黄子韬的方言梗，估计是对麻花期待感比较高，整体剧情不算幽默，整个影厅也听不到什么笑声，大家也都在嘀咕剧情并没有风评的那么好笑，我觉得从剧情上来讲，真的只能获得3分，可能我笑点比较高，反正从头到尾没笑  3，演员整体演技全部在线，没得说，尤其是马丽那段电梯表演，我真的心动了	负面	正面
没有剧情 烂片	负面	负面
笑完哭，哭完笑，纸巾用的格外快。之前一直没有get到马丽的颜值，这一次真的感受到了。这也太帅了吧！ 宇宙级别的浪漫，两人的合体真的满足了期待。	正面	正面
好看，还可以	正面	正面
好看很搞笑.	正面	正面
说不好不会被骂吧？	负面	正面
可以，很搞笑	正面	正面
好看 但没那么喜欢	正面	正面
还行，不是烂片	正面	正面
挺震撼的还搞笑	正面	正面
冲着喜剧去的，结果一点也喜剧	负面	正面
搞笑且感动，不错	正面	正面
沈马永远的神 呜呜我爱沈腾马丽老师	正面	正面
好电影，值得一看。	正面	正面
非常好看 开心麻花很用心	正面	正面
可以 没失望 有笑点有泪点 可以看可以看。	正面	正面
结局太强行煽情了 结局我感觉我在看流浪地球 除了结局 前部分还行	负面	正面
剧情很好，我很喜欢！有泪点也有笑点。	正面	正面
特效很棒，故事剧情有待改进	正面	正面
为了看沈腾，近期电影里可以一看的，不浪费钱	正面	正面
真的特别感人与搞笑	正面	正面
还可以吧，挺好	正面	正面
不错 挺好的 含腾量很高	正面	正面
非常好 1111	正面	正面
一般般看不懂	负面	负面
可以，好看，很不错	正面	正面
太好看了，4G特别的刺激	正面	正面
情节一般哈，强行搞笑。	正面	负面
十分好看⋯我们	正面	正面
挺不错👍，	正面	正面
张吃鱼导演的这部独行月球还是很不错的，它的剧情设计的非常符合现实，可以推荐👍👍👍	正面	正面
巨好看，推荐推荐	正面	正面
一般般，没以前好	负面	负面
非常好，给你九分，怕满分你骄傲！	正面	正面
不错的，值得观看	正面	正面
还可以，前面很有意思，后边很像吴京电影流浪地球；	正面	正面
看过原著的再看这个实在有些尬～	负面	负面
烂片，懒得睡瞌睡	正面	负面
可以的挺好看的	正面	正面
还可以，孩子也能看	正面	正面
非常好很好看	正面	正面
太搞笑了，看了绝不后悔	正面	正面
不多说，赶紧买票去看	正面	正面
好看就是结束不喜欢，不过也许这就是人生总有点遗憾。	正面	正面
还挺不错的吧	正面	正面
很喜欢这部电影，内容生动有趣，最后结局很感人。为身后默默无闻献身航天事业的英雄们致敬，我们的和平与稳定离不开这些英雄的付出！	正面	正面
好看	正面	正面
又搞笑又感人的，感觉还是不错的	正面	正面
沈马组合 必须看啊 太太好看了	正面	正面
非常不错👍😌	正面	正面
又哭又笑 好看好看	正面	正面
不咋样	负面	负面
笑点不好笑，全场大家有尬笑五次？泪点不好哭，强行煽情	负面	负面
含腾量满满，故事还可以，情节有点曲折，细节不必去追究，笑一笑，也蛮好。总是看到马丽绷着一张脸也不是很舒服，这难道是剧情需要？虽然是一个带有科幻性质的电源，但千万不要把它当成科幻电影。这是一部喜剧。	正面	正面
可以永远相信沈马，发挥一直很稳定，结局很喜欢没有强行大团圆	正面	正面
特别甜，不虐	正面	正面
自己一个人去看的，感觉还不错 有一个彩蛋	正面	正面
特别好看，有哭有笑。	正面	正面
可以，一般般	正面	正面
挺好看的，加油	正面	正面
不知道这么高的分哪里来的，和夏洛特烦恼相差太多了。	负面	负面
很不错  非常喜欢	正面	正面
挺好看的，搞笑剧	正面	正面
沈马cp绝绝了 喜欢	正面	正面
搞笑确实还行，但煽情方面还是不够真实！就是一本喜剧里偏要放点其他东西，味不纯了！	正面	正面
很好，开心麻花值得信赖	正面	正面
画面和特效是真的很好看啊！！尤其是爆炸的那段，我觉得完全可以拿来当壁纸，剧情也OK，其中的笑点是真的很多而且真的很好笑，尤其是点灯的那个时候，真的头都给我笑飞，最后吧我觉得这个结局还是比较出人意料的，不同于平时的大团圆的结局一下子就让我感觉是有点东西在里面了。	正面	正面
很好看。有喜有悲。	正面	正面
还不错 👍👏	正面	正面
好好好好👍	正面	正面
剧情紧凑，特效不错	正面	正面
喜欢沈腾演的戏	正面	正面
呜呜呜 好看 虽然有感情戏 但是是格局很大的感情 不拘泥于两个人 七夕才来看 但是很喜欢	正面	正面
挺搞笑后面催泪，沈腾马丽演的不错，结局也很真实，没有玛丽苏	正面	正面
可以😌！好	正面	正面
垃圾 没零分选项	负面	负面
好看，值推举，非常搞笑	正面	正面
一级棒支持国产	正面	正面
可能期望值太高，剧情太老套真心不好看	负面	负面
还行，就是搞笑	正面	正面
有包袱有感动还有中式英雄主义！！值得一看！	正面	正面
挺有喜感的一部电影，大人孩子都适合看	正面	正面
一个回不了家的人，是孤独的。一个死也没能落叶归根的人，又悲壮又孤独。	正面	正面
挺好看，有意思	正面	正面
“我的肩扛得起整个星河，却扛不起你思念的泪” 马丽，沈腾演的还有什么可说的，欢笑接连不断，但是在情节穿插的过程中，也有不少泪点，剧情跌宕起伏，让人猜不到下一步的做法和发展态势，非常吸引我，袋鼠在之中也是一个点睛之笔，妙趣横生，如果你想要一个开怀大笑又不失泪点的观影体验，我个人觉得非常推荐！	正面	正面
扣人心弦，太好看了	正面	正面
沈马组合就觉得不简单，看了之后果然没让我希望，剧情很搞笑也很感动。 🌟 推荐	正面	正面
沈腾马丽的电影，必须好！大卖，真的爱死了	正面	正面
太好看了  特别搞笑	正面	正面
又搞笑又感人 值得票钱	正面	正面
小红书果然没有骗人全程只有尴点！我都带上耳机开始听歌了 ！	负面	正面
麻花还是那么搞笑 后面哭的要死	正面	正面
爆笑连连，非常，非常，非常推荐！重要的事情说三遍，一定要看，一直支持沈叔叔！！！	正面	正面
好！非常值得一看	正面	正面
跟孩子去看的，孩子说还可以	正面	正面
很不错 画面感很强 磕沈腾马丽	正面	正面
一般般，结局不好	正面	正面
挺好看的，真的	正面	正面
沈叔叔就是票房保证	正面	正面
有搞笑，有道理，很棒。	正面	正面
沈叔叔的电影好看，不错	正面	正面
还可以，喜欢沈腾和马丽	正面	正面
我觉得相当一般	负面	负面
有点失望，这不该是沈腾该有的表现	负面	负面
很好看，前期搞笑，后期感人	正面	正面
爱一个人，拯救世界，为伟大事业牺牲，是男人的终极浪漫幻想了	正面	正面
还行，看完记忆不那么深刻，笑点也一般	正面	正面
就那样吧也没啥意思像火星救援剧情太老套	负面	负面
很感动啊……	正面	正面
很搞笑值得去看	正面	正面
还不错   挺好看的	正面	正面
'嗯好好看放松	正面	正面
又哭又笑，都是腾哥给的，真的是特别好的电影！！	正面	正面
感觉还行，感觉有一些存在比较奇怪的地方，但是总体上还是不错的，沈腾还是把搞笑和煽情融合的比较好的，算是值得一看吧。感觉最近中国拍的太空题材的还是不错的，继续加油吧。我对此很有信心的。	正面	正面
电影太好看了吧	正面	正面
真的拍的很不错，每一个瞬间腾哥都把人物的感情演绎的淋漓尽致，去接刚子的时候，在面对生存和伙伴他选择了后者，很感动，刚子是他唯一在孤独的月球生活中的同伴。并不是每个人都可以当英雄，独孤月的沉着冷静幽默和误以为地球发来的信号支撑着他度过了几百天，他用自己去守护了他所爱的家园和每一个人，醉后化成了蓝色光环一直在我们的身边👍👍👍👍	正面	正面
说实话，很失望。	正面	负面
无聊。。睡着了	负面	负面
所以马蓝星等到独孤月了吗？	正面	正面
可以看，没有太多新意和新梗。合格的爆米花电影，打发时间的话不亏。	正面	正面
感觉剧情不太链接	负面	正面
去看的时候没想到会是感人的，去了5个哭了2个半，我觉得感人级别还是不错的，腾哥搞笑yyds	正面	正面
开心麻花让我惊讶！本来看了一些差评不抱太大希望，但是开始看后就觉得剧情很吸引人，除天文物理知识不懂外，剧情没有硬伤。两位喜剧演员没有以往喜剧代入感，很适合角色。哭了好几回，沈腾演这种正面人物也很有说服力和感人。道具服装场景等很逼真。 笑中带泪，有家国情怀也有儿女情长。	正面	正面
挺搞笑的，但更多的是感人，很励志	正面	正面
比较富有想象力的一部电影，就是最后有些惆怅。	正面	正面
疫情时代下，我觉得这个主题是很有意义的，如何在绝望中寻找希望，正是给当下这个经济低迷，世态动荡下人们低落的情绪加了一针强心剂，有助于提升社会积极应对任何挑战的决心。我相信执着的力量，那种在逆境中前行的勇气永远值得点赞！我觉得这是一部良心之作，处处透露着创作者们对细节的完美追求，满满的诚意打动人心。我觉得这是近年来那么多喜剧中最打动我的一部！轻松好看还能有点意义，真不知道为什么那么多人觉得作品把观众当傻子，喜欢看就是硬道理，那些自视品味很高的仙人可以闭上你们不懂“尊重”的嘴，这部作品完全没必要被喷，我欣赏沈腾的创意，如果买IP那么简单，为什么近几年我都看不到几部真的能让大众入心入眼的佳作。任何作品，有市场才是王道。	正面	正面
蛮好看的，很励志，带大一点的孩子看看还可以哦，	正面	正面
喜剧和科幻题材相结合题材很新颖，但观众不太好共情，导致片中煽情片段没有共鸣，觉得很尬。   不仅因为是喜剧片，在服化道非常用心，特效浑然天成，希望以后能有同类的电影，甚至超过他。	正面	正面
总体来说还是不错的。	正面	正面
我后悔了，我情愿在家躺着玩手机！	负面	负面
真的很可以	正面	正面
很搞笑，我儿子笑的前俯后仰的	正面	正面
很好呀 我喜欢	正面	正面
睡着了，醒了就散场了	正面	负面
科幻搞笑片  来自宇宙的终极浪漫是变成星带永远守护你 值得一看	正面	正面
原来含腾量不是搞笑的保证	正面	正面
一般，可看可不看	负面	负面
很有意思 很好看	正面	正面
太好看了吧，差点没把我笑过去。	正面	正面
好看哦，可以康康	正面	正面
后面很感动😭	正面	正面
煽情过久，而且都知道袋鼠是澳大利亚的代表，最后树个袋鼠纪念碑，啥意思啊？	负面	负面
剧情不紧凑、内容不充实、有点尬、硬凑笑点、	负面	负面
挺好看，结局很意外。	正面	正面
一般般。特别是后40分钟，看得想睡觉。	负面	负面
真心一般，偷票房，不然怎么会有这票房，还有就是洗东西，大家都懂	负面	负面
梗还都在梗上	正面	正面
演技都很棒啊！后面真的太好哭了 🌟 推荐  😂 笑点	正面	正面
不错不错，挺好看，	正面	正面
腾式喜剧，值得一看	正面	正面
真的很不错呀	正面	正面
好看好看的电影。	正面	正面
好看！哭的稀里哗啦！呜呜呜！	正面	正面
搞笑又感动的电影	正面	正面
还可以，演技逼真！	正面	正面
太好看了吧，刚子说他不坐，他要飘回去	正面	正面
真的是很好看，不愧是黄金组合	正面	正面
可以值得推荐带小孩子去非常棒	正面	正面
有沈腾的电影，质量还是有保证的。	正面	正面
好看，赞赞赞赞赞赞，喜欢开心麻花	正面	正面
腾点超级高~	正面	正面
挺好的，就是有些不喜欢在月球上一个人孤独的氛围	正面	正面
剧情垃圾，爆米花电子又没有笑点	负面	负面
剧情不拖沓，有感人有搞笑，点赞，很值得看	正面	正面
不错不错，前期搞笑，后期感人	正面	正面
沈腾从来不会让人失望，你可以永远相信他。	正面	正面
好好笑，笑死了	正面	正面
还阔以的看咯	正面	正面
超级无敌好看	正面	正面
挺好看，，，	正面	正面
好看，不过超越不了以前的	正面	正面
不好看，没有沈腾这部电影就费了，不要浪费钱，不如等线下再看。	负面	负面
太棒了，和ta一起去看	正面	正面
独行月球，喜欢💕	正面	正面
还好还行吧，适合小朋友看	负面	正面
没有豆瓣评的那么差，也没有期待中的那么好，喜剧吗，看过后能开心笑过就好了	正面	正面
好看，不错挺好的	正面	正面
剧情很不错，有些遗憾，但遗憾才是人生常态 🌟 推荐	正面	正面
有点像流浪地球	正面	正面
一个人的信念感真的很重要 加油	正面	正面
感觉还可以，好评率太高，所以期望值高	正面	正面
有笑点，有泪点，有深意。 搞笑，感动，向上。 麻花近年最棒的作品。 独孤月，我们回家！	正面	正面
还行 这个题材拍成正剧会更好 玛丽有些地方演技没接住还是会有点尬 笑点泪点都有 中规中矩吧	正面	正面
挺好看的电影，2D看的很舒服，不像3D看完那么累，沈腾特别搞笑，画面也不错	正面	正面
值得一看的。超级无敌喜欢沈腾马丽	正面	正面
很好看，笑点很多，也很感人。真的是让人哭笑不得😂！！	正面	正面
剧情温馨搞笑	正面	正面
挺好看的，感人	正面	正面
搞笑，喜剧推荐	正面	正面
真的很无聊，营销号做的不错👍	负面	负面
还不错，不愧是沈腾主演的片子	正面	正面
不如李焕英，有点强行CP，强行煽情	负面	负面
非常好看值得	正面	正面
你一中这类一呢特有多做头赢你	正面	正面
跟朋友一起去的，感觉还可以	正面	正面
超级难看，没有达到开心麻花的水准。不推荐看！	负面	负面
还可以，整体效果前期搞笑，后期伤感。	正面	正面
怎么说呢，座无虚席好看至极	正面	正面
很不错，含腾量100%	正面	正面
有点意思，看见沈腾就想笑。	正面	正面
因为疫情影院零星几个人，有一种包场的感觉前面笑的很放肆，泪点笑点多的一批在独孤月以为世界真的就剩自己放弃时全世界为他点起星星之火，还有顶流刚子不愧是顶流！！以及韬韬的假发真的是我影响最深的笑点，小女孩的哭戏也是很赞👍🏻最主要的是虽然是一个镜头但是确实很好笑的徐志胜🤦🏻‍♂️(脱口秀届鹿晗)其实从一早开始独孤月就不是单恋！！🥺(我不管)	正面	正面
科幻而又感人	正面	正面
还可以，跟想象的不是特别一样。含腾量高。	正面	正面
挺不错的，建议观看	正面	正面
电影院不咋地	正面	负面
含腾量高。挺不错的	正面	正面
鬼节看电影。。。	正面	负面
都不错都不错	正面	正面
非常喜欢，好看	正面	正面
根本不知所云。	负面	负面
俩人的表演可谓是精彩绝伦，喜剧中的科幻，本质还是喜剧片。都说悲剧是喜剧的内核，从独孤月被丢下的那一刻起就想哭。科幻片的基调永远是沉重和孤独，但人类总是在黑暗中不停追寻着光明。  以星环为戒，流星是我送你最璀璨的礼物。  独行月球冲啊！！！！！！！！！！	正面	正面
看过了，非常好看	正面	正面
挺好的，推荐看	正面	正面
美得很，感动得很	正面	正面
还行，就那样吧	正面	正面
还行吧剧情简单	正面	正面
非常的赞，值得推荐	正面	正面
很好太好看了	正面	正面
还可以的，推荐	正面	正面
很好看，我觉得因人而异吧，反正我觉得好看	正面	正面
超级好看快来看吧	正面	正面
超级好看，超级赞	正面	正面
好久没有看过这么棒的喜剧了，沈腾再一次证明了自己是一个出色的演员，能够吸引观众们的兴趣，影片虽然还是以喜剧为主，但是电影里恰到好处的经典配乐加上其生动的表演，为电影更增添了色彩，剧情方面包袱推动了剧情的前进，使电影更加有趣，最后，这部电影的特效部分尤为出色，完全可以当做科幻片去欣赏，建议在IMAX、杜比等特效厅观看。	正面	正面
不错 😂 笑点  🎉闪光点	正面	正面
挺好的，值得推荐	正面	正面
烂片，妥妥的烂片！给1分都怕导演骄傲起来 拍第二部！！！烂到家。	负面	负面
干净又卫生！	正面	正面
真的算是好看的电影，个人比较喜欢这种不是为了感动而感动，类似无名之辈这种以喜剧方式渲染情感的！推荐	正面	正面
好看默默^_^	正面	正面
不错？！？！	正面	正面
1分都不想给，烂片还钱！	负面	负面
很有喜剧感。	正面	正面
个人感觉剧情还可以，不过没有以前开心麻花拍的更好笑。	正面	正面
挺好的，好笑	正面	正面
很好看，不止搞笑剧情演技完全在线，沈马组合永远的经典！！非常推荐大家去看	正面	正面
好看好看开心麻花的电影一部也没有错过	正面	正面
还不错，就是票价有点高	正面	正面
无聊的电影，睡觉了	负面	负面
太搞笑了很好看	正面	正面
好看不多说。。	正面	正面
可以，真是搞笑	正面	正面
你永远可以相信沈腾和马丽	正面	正面
好看。有笑点，有泪点。赞👍	正面	正面
笑点一般般，泪点不存在，勉强给个及格分	负面	正面
不错！看了两遍	正面	正面
还不错，有泪点有笑点，题材也好，还有点科幻片的感觉，科技风不错，可以说是一次大制作了，就是个人觉得笑点比杀手不太冷静差了点意思	正面	正面
无厘头搞笑，挺好	正面	正面
不错，搞笑的搞笑，也有泪点	正面	正面
很好，这类题材的电影真的非常有意思，让人从人性角度去看待身边的人和事，尤其一个人被扔在月球，看着遥远的地球，心里真的让人很难受，那里才是我们的家，突然有种看到自己父母的感觉，当看到地球被小星星撞击后发生毁灭，那种寻死觅活的样子真的让我们很感慨，加油，希望中国能出更好这样优秀的电影🎬	正面	正面
特别搞笑很好	正面	正面
#独行月球# 这部含腾量超高的麻花科幻喜剧电影可以说是相当精彩 🌟 推荐 可以二刷，三刷了！ 借用电影里台词：难过归难过，该吃吃，该喝喝。	正面	正面
笑点尴尬 剧情拖拽没有逻辑 强行煽情 唯一的好的就是配乐是天花板	负面	负面
我觉得很好😭😭😭	正面	正面
很喜欢，很久没有看到完整度接近完美的电影了	正面	正面
很好看的一部电影，特别加上沈腾马丽这对CP，这种含蓄又深刻的情感流露让人动容，其实影片中他们在一起的时间不多，可是让人看了就觉得他们对彼此有深情。	正面	正面
一颗星给沈腾和马丽 ，另一颗给观众席笑点低的观众	负面	负面
不错，非常好看的电影。	正面	正面
还可以，刚子拉车时音乐好听	正面	正面
故事反转，欢笑之后有感动	正面	正面
整部电影还是靠沈腾演技支撑！要说搞笑片真的一般，不过电影中的几句台词很喜欢“遇到什么困难，都不能轻言放弃”	正面	正面
搞笑中又深受感动，沈腾的演技一如既往地精彩	正面	正面
有笑点  有泪点，不错！沈腾从来没有让人失望	正面	正面
笑笑笑。嗯嗯	正面	正面
还可以，剧情一般般。。	正面	正面
开始的震撼与搞笑让人笑到流泪，结尾的英勇让人哭到流泪	正面	正面
一般一般般啦	负面	负面
还行吧！笑点不多	正面	正面
很好看，要去看	正面	正面
感觉非常不错	正面	正面
含腾量百分百确实搞笑 值得一看	正面	正面
强烈推荐，难得的佳作	正面	正面
看见沈腾就想笑	正面	正面
电影不错就是电影院没人，体验了一次包场	正面	正面
故事角度不错。演员演技也ok。最后的选择也有了英雄主义的味道。	正面	正面
加油，再写仨字就能发表评论了	正面	正面
非常喜欢，而且很感人	正面	正面
太好看啦 爱死沈叔叔啦！！！！！	正面	正面
沈郎永不才尽	正面	正面
非常棒！精灵旅社万岁！	正面	正面
非常好看，也很精彩	正面	正面
含腾量极高🥰笑点满满	正面	正面
好电影，真的好看，全程无尿点	正面	正面
不错啊，很值得一看	正面	正面
好电影 无需多言	正面	正面
可以可以稳当	负面	正面
还可以，一般	负面	正面
剧情不错，拍的真不错，沈腾马丽一直没让我失望过。	正面	正面
还行，觉得袋鼠月球飞天的那一刻很帅	正面	正面
电影很好看，让我体会到了归去，也无风雨也无晴的人生哲理，值得去看	正面	正面
如果是真喜剧就好了，不要煽情。不要升华。不要拔高！	正面	正面
还不错可以看	正面	正面
不错不错…………	正面	正面
我说真的 非常之无聊 低级趣味 浮夸 悬浮，全程没笑没哭，本人笑点不高的，算是我看过这么多电影以来最差的了	负面	负面
宇宙这么大，我们终会再见	正面	正面
😂 笑点 有的	正面	正面
好看，值得去看一下	正面	正面
很有意义，传达正能量	正面	正面
推荐推荐，味道不错，干净卫生。	正面	正面
非常好看啊 沈腾居然给我看哭了	正面	正面
好极了棒极了	正面	正面
内容充实又有趣	负面	正面
店里的装修风格感觉很简约时尚，又带点小特色，很适合📷拍照噢	正面	正面
融合了喜剧煽情元素，配乐相当优秀。喜欢金刚鼠，可以二刷！	正面	正面
有喜有忧 有挑战人性时刻。挺不错的	正面	正面
不错，感人，希望在出好作品	正面	正面
挺好看的 看电影就是为了笑一笑	正面	正面
一般般，不太喜欢。	正面	负面
我也想要刚子	正面	正面
保护环境 保护环境 保护环境 好看 能拯救人类的 还是人类自己	正面	正面
我先表达一下我自己的观点，首先这个电影真的是笑点很足，而且除了春节档有电影能跟这个相提并论吗？而且沈马CP也确实很磕，强行煽情肯定是有一点的，但是我们不用把它说的这么难听，总体来说已经是一部不错，值得去尝试的电影了，不是任何电影都是完美的，喜欢就是喜欢，不喜欢就是不喜欢，这都很正常。饰演刚子的人演技也超高，在分别的那段真的让我流泪了，彩蛋也可以是一个转折的一个点，希望大家都客观评论，谢谢	正面	正面
不知道这个9.3分怎么来的	负面	正面
1分给沈腾，剧本负100分，商业诈骗	负面	负面
不限时这一点真的爱了，可以慢慢悠悠的享受整个过程，被治愈了体验感非常不错，分泌了超多多巴胺，超级快乐！	正面	正面
和婶婶婶婶玩了个游戏都玩	正面	正面
为了沈腾马丽去看的，果然开心麻花还得是沈马组合最有看头，其他人也很棒啦 看的时候一会哭一会笑一会感动的，虽然没有夏目特烦恼那么搞笑好看，但真的挺好看的 含腾量100%，期待开心麻花下一部作品	正面	正面
只能说刚刚及格吧！	正面	正面
不关注剧情，嘻嘻哈哈看完就行。	正面	正面
剧情特别感人！真的是笑着笑着就哭了，哭着哭着就笑了！一部特别值得一看的电影！	正面	正面
搞笑又不失温情！	负面	正面
还不错，有意思	正面	正面
有笑点，很多部分很牵强，感人部分没有感觉到多感人。有点像火星救援的情节，一般般	负面	正面
非常不错。。。	正面	正面
喜剧中表达了孤独，个人和集体利益的取舍	正面	正面
还不错，挺有意思的！	正面	正面
挺好的，剧情	正面	正面
很搞笑，剧情也很好，励志	正面	正面
特别好 剧情很棒	正面	正面
沈腾马丽主演的电影一直没让人失望过，搞笑中带着感动，感动中带着大爱  强烈推荐	正面	正面
挺好的，既感动又搞笑，支持沈腾	正面	正面
特别好看，搞笑	正面	正面
值得一看，带着孩子看的，笑过之后很感人	正面	正面
觉得挺好看的，有笑点有泪点，跌宕起伏，推荐	正面	正面
非常好看 尤其是刚子	正面	正面
没白期待《独行月球》，今年最好看的喜剧电影没跑了！包袱应接不暇，爆梗接二连三，整个影厅都笑得前仰后合，氛围超欢乐，永远可以相信开心麻花的喜剧功力！  影片中的地球人和影厅里的观众一起围观沈腾在月球上的社死日常，“含腾量”超标没骗人！月球上“沈鼠鼠”cp拳力以赴的相处日常“萌力”满满，每一拳都能击中我的笑点，地球上的围观群众也贡献超精彩reaction，简直是在当场演我，又真实又好笑，特别是wuli 黄子韬，每次一出场都是高光，能让人笑出眼泪的程度，明明是天生的喜剧人就别当偶像了  不得不说，独孤月的月球直播真的有魔力，不光让电影里的地球居民重拾生存信念，也能让影院里的我们抛下一切烦恼，开启心灵的外太空漫游，外太空零重力，看电影零压力，轻松解压，毫无负担，舒爽感赛过做SPA，甚至想要加钟二刷！	正面	正面
有笑声有泪水	正面	正面
搞笑加感动真不错	正面	正面
很棒腾哥还是这么好笑演技真的很棒	正面	正面
有笑有泪。好看	正面	正面
好看。情节感人，言语幽默。配角也出彩	正面	正面
挺好的，拍的不错	正面	正面
非常好！好看！	正面	正面
特别好，好，	正面	正面
真的很不错朋友们，不要听dy上的人乱说，自己去看了才知道一部电影好不好	正面	正面
很好看，很搞笑很感人	正面	正面
推荐大家观看这个电影 🌟 推荐	正面	正面
搞笑又感人，很值得看	正面	正面
很棒 科幻加喜剧 😊 演技  😂 笑点  🎉闪光点	正面	正面
不带脑子看还挺好看的，含腾量十足，不过要抛弃逻辑	正面	正面
孩子自己看的，说是挺好看	正面	正面
不怎么样，一般般。	负面	负面
不错的题材电影 喜欢💕演员 继续加油 小盆友可以多多看 好看好看	正面	正面
逗死我了，笑的肚子痛，结尾很感动。非常棒！	正面	正面
个人感觉挺好的	正面	正面
很好看，沈腾666	正面	正面
很好看喜欢 😂 笑点	正面	正面
演技好，很生动	正面	正面
激励性强适合孩子们看！！！！！！！！	正面	正面
为什么会有这么高的评价？ 被评分忽悠了，真的看睡着了，剧情拖沓，也没有那么搞笑	负面	负面
如果失望是灰色的，那么希望就是这灰烬中飞出的凤凰。好笑吗？好笑。一个普通人，普普通通的人，自以为是天选之子，没错，上天选来出消遣的傻子。却在上天把玩的蹂躏和践踏中，磕掉铅华，露出光芒。就是这样陈词滥调的老梗，或许这梗讲了1000年，亦或许1000年后还有人再讲，但总有人听不够，因为总有那些包藏着人性最美好的那部分光辉的心，与之产生着共鸣。靠谱，不一定都是大义凛然，伟大，不一定都是光芒四射。那一只只托起希望之光的手，何尝不是布满老茧，沾满泥巴。Country roads take me home, to the place I belong. 每个一卑微的伟大者的人。	正面	正面
超好看。开场就喜剧效果拉满，很容易把人以最快的速度带到电影中。后续故事很精彩，总有出其不意的笑点。故事中还蕴含着发人深思的东西，很深刻。后面的故事有感动也有遗憾，感情很丰富。故事情节铺垫，台词呼应都很细心，还有好多细节值得深挖。很好很好	正面	正面
和你在一起看的最后一部电影了吧	正面	正面
真的垃圾，原本很喜欢沈腾的，但是这部电影真的烂片…尴尬到抠出三室一厅，小品电影，无聊！强行催泪… 而且我们不需要偷票的电影，谢谢	负面	负面
很好看 全程都好看	正面	正面
最后的彩蛋🥚里有π+撞击碎片在地球周围形成的超浪漫的美丽星环₍ᐢ •⌄• ᐢ₎推荐观看！	正面	正面
还不错，五星好评是孩子让给的	正面	正面
有笑有泪，全片剧情跌宕起伏，演技在线，演刚子的演员应该很辛苦，电影院里座无虚席，连离银幕很近的排居然也坐了人，上一次我印象中这样的情况还是在看（你好李焕英）的时候，独行月球的主演沈腾，马丽，常远都演技在线，一些配角也很出彩，比如老戏骨李鸿儒，还有黄才伦都有很惊艳的出彩瞬间，还有一个演八级电工的那个演员，名字不知道叫什么，但是很搞笑，还有一个小女孩演的也很好，眼神纯洁闪着光，强烈推荐，我准备再去二刷。😀	正面	正面
肾疼要这种正能量 很不适应     就该做喜剧演员	正面	正面
挺不错 笑中有泪 刚哥很给力 开始觉得意外 后面明白了它存在的用意	正面	正面
太好看了，一个大男人看哭了2次。	正面	正面
好看，挺搞笑的 😂 笑点	正面	正面
最后泪目，和流浪地球挺像的	正面	正面
就科幻片来说，虽然没有那么硬核，但整体逻辑和呈现效果不错，《流浪地球》之后又一部合格的国产科幻大作（两部电影名可以组cp了啊哈哈哈）。 就喜剧片来说，笑点不多，分布零散，且主要集中在前半段，沈腾一人就撑起了80%的笑点。后半段的情节还有高潮的煽情是真的笑不出来，也不能痛快的哭，只能让眼泪在眼睛里打转，然后又流回去。喜剧片这样煽情属实有点犯规了。 值得表扬的是音乐和画面很美，一些镜头配上音乐真的美到想哭，还是用了心去研究构图的，狠狠地舒服到了。 总之，今年院线为数不多值得一看的电影。 （刚子应该算小女主了吧（bushi），和动物组cp还真挺新鲜啊）	正面	正面
好看，支持，	正面	正面
剧情 画面 演技 拉满	正面	正面
特效不错 剧情不太行	正面	正面
没有让人失望	正面	正面
一样一样的电视上	正面	正面
希望大卖，实打实的棒	正面	正面
含腾量很高，电影不错，很适合老少皆宜去看。科幻带喜剧，幽默风趣又不失人间真理！	正面	正面
搞笑不缺乏感动，彩蛋非常好 🌟 推荐  😭 哭点  😂 笑点	正面	正面
Nice，值得一看。	正面	正面
搞笑剧情，演技超级好	正面	正面
好看，观影途中有欢笑有泪水，总体观看体验非常好，疯狂推荐电影。腾叔的“马蓝星带我回家”印象非常深刻～支持，祝影片大卖！！	正面	正面
超级好看 开心麻花一煽情就特别好哭 沈腾太帅了 马丽太美了 是我的影后影帝 这次电视影是大制作 相比之前的喜剧片这次又高级创新又搞笑又富有感情 很让我们观众喜欢 有感觉 在独行月球的旅途 是多么的奇幻勇敢 和恐惧焦急  🌟 推荐 很推荐！！！	正面	正面
超级好看，下一次的电影我何多鱼投了	正面	正面
剧情乱没逻辑性，坚持看了一个小时就离开了。	负面	负面
很好的作品，也很搞笑	正面	正面
较好值得一看	正面	正面
实话实说，剧情一般，及格分吧！情怀和主题都点到了，共鸣感也拉到位了。感觉泪点比笑点更多，笑点有的可以，有的就比较硬了，包袱少了些，质量也可以更上一层楼。有几个点记忆深刻: 丑的先死，还是帅的先死呢？ 都得死！😂 还好，大部队还在！（轰的一声，齐刷刷都起飞了😂） 一个好消息，一个坏消息。好消息是再没有坏消息了，坏消息是再没有好消息了！（此处略显心酸与悲壮）😭	正面	正面
不错，喜欢沈腾马丽	正面	正面
太有意思了，大力推荐， 有泪点有笑点，告诉大家有时候一种精神状态，不服输，不认输，独孤月牺牲了自己保护了金刚鼠，马蓝星，和地球，鼓舞一些人不要为了一些小挫折而放弃，也会有希望的， 总的来说从夏洛特烦恼一直到现在等了好久中学等到沈腾和马丽的合作没有白等，非常棒，有时间一定来一遍二刷，再看一遍， 还有彩蛋，也很精彩！！！	正面	正面
一个半小时就能讲完的故事拍了两个小时，另外这感情线没有铺垫根本带入不进去，不如像原著一样认认真真地把故事讲好，非要加点爱情元素吗？加就加了还这么没水平	负面	负面
剧情很好，画质清晰，非常棒	正面	正面
非常好看，强烈推荐各位去看，尤其是喜欢沈腾的	正面	正面
好裤子是死快上课快上课	正面	正面
特别好看，好笑又好哭	正面	正面
剧情比较有意思	正面	正面
剧情不知道咋说，但是欢乐中很感人肺腑	正面	正面
开头真的很搞笑，居然还有人给差评，但我想说起码整个大厅的人都在哈哈大笑。情节简单且似曾相识，虽然像是把以前看过的科幻电影重新拼凑起来一样，但像这样注入的搞笑元素的科幻题材真是不多，而且这次是开心麻花加持，这几年电影市场受疫情影响能拿得出手的大片真没几部，独行月球可以算是其中一个。	正面	正面
不咋地，是真的不咋地，没意思，	负面	负面
这1分是给袋鼠的。太无聊了。	负面	负面
电影行不行 主要看坐在旁边的人行不行 😊	正面	正面
真的非常好看	正面	正面
还是蛮好看的😄	正面	正面
烂片，绝对烂片，好评都是刷出来的	负面	负面
非常棒的一部电影！！	正面	正面
棒极了特别赞	正面	正面
特别好，可以去看看！笑点高	正面	正面
又搞笑又感人，那个演袋鼠的演员真的好好	正面	正面
没什么意思，不太搞笑，不如以往的作品	正面	负面
很棒，有笑点，有泪点，情节在情理之中，意料之外。	正面	正面
很棒，你永远可以相信腾哥，这部电影是我人生中第一个让我哭的中国电影	正面	正面
一般般吧，跟以前比没感觉	负面	负面
情节像儿童片	负面	负面
很不错的电影，搞笑又科幻！	正面	正面
好看的，结局很感人	正面	正面
这个电影真的很好看	正面	正面
很适合周末和朋友们一起来呀，度过一个快乐周末！也推荐大家来呀	正面	正面
个人觉得一般，喜欢沈腾的可以去看看，很有沈腾风格。	正面	正面
又哭又笑的 被人当深井冰了	正面	正面
剧情很不错，有笑点有泪点，也没有强行改成特别完美的结局，影片中特效做的也十分用心。	正面	正面
笑点十足，也有泪点，腾叔叔演技真好，沈马组合yyds，真的值得去看！你一票我一票必须帮腾哥拿个影帝回来！	正面	正面
太搞笑了，很好看，值得推荐	正面	正面
滴滴滴滴滴滴地对地导弹	正面	正面
全程没怎么笑，看着前两部沈腾的片子想着这部也差不到哪去，结果现实和想象差距有点大，跟朋友一起来看的，朋友在边上打呼了……前排小朋友到是笑的开心……就想来看把喜剧，结果莫名其妙的煽情和烂透了的老梗。跟夏洛和西红柿差距大的不是一点半点，要么有孩子的可以带来看看，讲真前排小朋友笑声没停过………能退钱不………	负面	负面
喜欢开心麻花，喜欢喜剧的可以去看	正面	正面
剧情有搞笑的也有感人的点，整得我又哭又笑，自我感觉这个电影还是不错的值得去看	正面	正面
太好哭了！！！！！！ 顺便捞个人， 八月三号十点到十二点那场的电影 一个人来的那个男生,坐在我朋友后面的 想认识一下 有兴趣的话可以回复一下没兴趣就当没看到谢谢谢谢谢谢谢	正面	正面
一名民工嘻嘻嘻嘻嘻嘻嘻	正面	正面
可以的，有笑有泪...	正面	正面
好好看，时而哭时而笑，节奏很好，孩子都很喜欢这部剧。	正面	正面
哈哈哈，还不错，喜欢看	正面	正面
超级棒  沈叔叔不愧是沈叔叔	正面	正面
很好看呦，真的绝了，推荐大家看啊	正面	正面
还好吧！我以为是很搞笑的，最后以悲剧结尾，	正面	正面
安全指示灯太亮了	正面	负面
真好 有笑点 有泪点 沈马出品 必是精品	正面	正面
制作挺不错。喜剧效果不错，也有感人的部分。挺喜欢的，沈马组合从不让人失望	正面	正面
不错啊！！！！	正面	正面
好 棒 推荐	正面	正面
不得不说，还挺感动的	正面	正面
画面还可以，就是广告插入太多太坑	负面	正面
笑笑哭哭真的很好看！	正面	正面
割韭菜，完全是流量	负面	负面
不是很好笑，剧情稍微不合理、黄子韬最后太出戏了，原本挺感人的，突然的色路让我猝不及防	正面	负面
好看，超级搞笑的，希望这种带来欢乐的电影越来越多，	正面	正面
画面震撼，情节搞笑。但又挺有意境的。	正面	正面
又好笑又好哭，演技杠杠的	正面	正面
优秀的电影，喜剧也能带哭	正面	正面
还不错 挺有趣的	正面	正面
真的很差劲。	负面	负面
好看好笑，值得推荐	正面	正面
刚开始太搞笑了，到后面我是哭着出来的，把人骗进去杀呀。	正面	正面
挺好的，值得拥有	正面	正面
满意，喜剧故事，也很催泪	正面	正面
很不错呦！好看	正面	正面
还算不错的，加油	正面	正面
个人感觉剧情一般,可以观看	正面	正面
相比较起来，画面不重要，制作效果不重要，重要的是影片传递的感情，挺好的，值得一看。今天连刷了2部，人生大事和独行月球，感概中国电影真的很厉害了，这么好的作品，值得一看。谢谢	正面	正面
挺好的 就是自己一个人看有点孤独	正面	正面
很不错，搞笑又感人……	正面	正面
忒别好看，又让人开心又让人悲伤😔  两个演员特别搭，也很有演技	正面	正面
还可以把挺好	正面	正面
高考，剧情挺有趣，演技也没啥多说的	正面	正面
还可以吧！故事也不错，笑点泪点都有	正面	正面
没有预期的好看，凑合着看吧	正面	正面
剧情一般，笑点集中在袋鼠，且明显不如夏洛特烦恼，感动的点有点硬	负面	正面
非常好是一部值得看的电影	正面	正面
呜呜呜超级好看！	正面	正面
袋鼠很逼真，沈腾很加分，不过感觉都是套路，看到一半也就猜到了结局。没有意外之喜	正面	正面
实在是太好看，又哭又笑，值得推荐！	正面	正面
搞笑，挺好看	正面	正面
整体有笑又泪，沈腾演技还是不错的，适合全家欢。	正面	正面
太太太太太太好看啦！！	正面	正面
好看，卫生也好	正面	正面
挺好看的，喜剧和感人并存	正面	正面
最后还挺感人的。	正面	正面
可以 很搞笑但是也有很动情的地方	正面	正面
剧情不错，推荐看看	正面	正面
幽默中带有感动，沈腾马丽的电影必看	正面	正面
还行😁 场面还可以 拯救地球的英雄+无法实现的爱情！我们都应珍惜这唯一的一次地球旅行！	正面	正面
一般般，感觉都没有《人生大事》好看。你说喜剧片吧，搞笑点不够，你说深度吧，也差点意思。可以尝试，但不要期望值太高。	正面	负面
维持吧，也就那么回事。	正面	正面
喜剧的内核是悲剧，他便乘了光	负面	正面
有笑点，也有泪点，尤其是沈腾饰演的独孤月牺牲前的一句话“马蓝星，带我回家”，当时我的眼泪就已经憋不住的流出来，就一直哭到电影结束，走出电影院眼眶都是红的 😭 哭点 “马蓝星，带我回家”                                              ——独孤月	正面	正面
好好看，搞笑	正面	正面
画面感很好，前面一直都很搞笑，最后的十分钟还是挺感人的，每人身上都有英雄主义精神，但不是每人都愿意成全其他人而牺牲自己	正面	正面
太一般了，有抄袭的嫌疑	负面	负面
电影很不错，推荐观看	正面	正面
红花还是需要绿叶来寸托…	正面	正面
独行月球画面感非常好前头非常幽默后面特别感人至深	正面	正面
还可以，男主角最后牺牲了。	正面	正面
画面很好，剧情也不错	正面	正面
好看，支持沈腾 马丽	正面	正面
故事情节完整，演员演技在线	正面	正面
还行 不错	正面	正面
含滕量满满！！！ 开心麻花出品 作为喜剧 依旧是爆笑	正面	正面
太搞笑了，太值了	正面	正面
还行，娱乐，含腾率确实高	正面	正面
好看哭了呜呜呜呜呜呜呜	正面	正面
含腾量99.9%，真的嘎嘎好	正面	正面
还可以，看了一堆刷一分的，感觉挺奇怪的。笑点有，泪点也有。不过没有太极致。都是点了一下就过去了。画面上倒是挺好的，不是低劣的产品。现在没啥电影看看挺不错的。	正面	正面
还可以吧 但是没有以前的好看	正面	正面
不是我喜欢的	负面	负面
非常好看的喜剧电影，又有泪点，还有教育意义，适合全家人一起看	正面	正面
一般般 😊 演技	负面	负面
还可以吧挺搞笑	正面	正面
很搞笑，不错的电影。没什么好吐槽的，国产演员和电影越来越好真是中国的强大	正面	正面
为了沈腾马丽去的 说实话一般 但是还是给了五星	正面	正面
蛮好的：剧情比较新鲜！有点意思！	正面	正面
整体布置的很ins风，很多角落都可以拍照，还有店里布置的灯光也很8⃣️错	正面	正面
最后男主拯救世界比较感人，其他剧情笑点一般吧！	负面	正面
盒盒盒盒。。	正面	正面
有喜有泪，值得二刷！	正面	正面
排得不错，特效不错，演员演得不错	正面	正面
可以可以特别喜欢刚子	正面	正面
太坑了，别去看了，真**后悔！	负面	负面
🌟 推荐  😊 演技  🌅 画面  😂 笑点  🎉闪光点 真的很不错很值的观看这边电影，有笑点又有泪点，从绝望到满怀期望，又到满怀失望，碟状起伏，最后他去阻止那个陨石的时候我以为跟那些庸俗的电影一样他会活下来，后面他没有活下来，他牺牲了他自己保住了地球，这种勇敢而大无畏的精神值得我们学习，和刚子的分别也让人泪目，从两个人一起生活依偎那么久各种的打闹到最后永远的离别真的哭死人了！我认为太值得看了，支持腾哥的电影🎬	正面	正面
超级好看  我永远支持沈叔叔！！！！！！	正面	正面
好看，感人，没白来	正面	正面
好看 沈马组合yyds	正面	正面
垃圾一分都不想给，全程尬，剧情就是哄三岁小孩	负面	负面
非常好看 强烈推荐	正面	正面
还我87块钱！！！	负面	正面
剧情很好	正面	正面
很不错的！值得观看	正面	正面
特好看，有深度	正面	正面
还可以吧！没事看看	正面	正面
只能说，最近没什么电影可以看，纯粹是为了打发时间，电影也是为了赚钱，没别的意思，都在应付	负面	负面
在一起了的感觉真的很喜欢你	正面	正面
不错 不错	正面	正面
一分给沈腾 一分给马丽	负面	正面
不知道该咋说，没有太多新颖，国内国外类似的电影也看的不少了，想睡觉，煽情也完全没有泪点	负面	负面
电影很好看，有一点心疼腾哥，笑的也很开心，刚子也好玩	正面	正面
有欢乐有悲伤	正面	正面
值得去看，本来以为拍出来会很拉胯，结果很好	正面	正面
前面挺搞笑的，后面剧情…	正面	正面
很不错，沈老板没有拉胯	正面	正面
搞笑＋感动非常好，哈哈哈哈哈哈哈哈哈哈哈哈哈	正面	正面
含腾量满满，最后哭的不行。	正面	正面
很不错，拍的不错	正面	正面
太烂了无语😒😒😒😒	负面	负面
睡着了兄弟们	负面	负面
很好看，很多笑点	正面	正面
“马蓝星，带我回家。”真的爆哭好吧	正面	正面
剧情很好，好看的	正面	正面
🌟 推荐我觉得挺好看的！	正面	正面
一般般，没有给到惊喜，笑点不够	负面	负面
特效很好 剧情可以接受	正面	正面
电影很好，就是那个座椅皮都磨掉了哈哈哈	正面	正面
电影挺好，特效很不错，最后还后出了我的泪点，但是电影院的椅子我得吐槽一下，晃来晃去，晃的头疼，也不跟剧情，就瞎晃，直接让我无法投入的看电影。而且还动不动就喷水，啥剧情你喷水，是怕我哭不出眼泪么，	正面	正面
特别逗，结局也很感人！	正面	正面
一般般吧，也就金刚有点笑点，其他的真的尬	负面	负面
很好笑，不错的观影体验	正面	正面
啊啊啊好看啊	负面	正面
嘎嘎的，好看，	正面	正面
剧情搞笑且感人	正面	正面
有感动有喜悦，更多的是要好好学习，不然这些生存之水，哪里来 🌟 推荐	正面	正面
好好非常好.值得拥有	负面	正面
悲情的喜剧更能感动	正面	正面
一如既往的搞笑，	正面	正面
整体不错，开心麻花成员演技在线，刚子演得不错。 不要去较真剧情合不合理，钢铁侠都能抱着核弹跑，沈腾为什么不行？ 疫情当下也算是一种积极的能量吧。	正面	正面
无聊的时候当个搞笑片看看还是可以的	正面	正面
画面、特效、演技没得挑，中国电影的进步着实令人眼前一亮。 单说剧情，笑中含泪、泪中带笑，实为佳作。 然笑点并未如想象般多，憾。	正面	正面
很搞笑，开心果，笑点新颖，	正面	正面
还可以，比较幽默	正面	正面
全部完美 棒棒的，老少皆宜，好好好！	正面	正面
有欢乐，也有温馨。	正面	正面
非常好看，开心麻花真的不让人失望，感觉可以一直期待	正面	正面
还得是沈腾马丽啊👍	正面	正面
给沈腾的星星。电影本身不想评价	正面	正面
还不错！！！	正面	正面
还可以    ！	正面	正面
好看，全程无困点，一直看完，有笑有泪	正面	正面
绝对柔软 🌅	正面	正面
这应该开心麻花出过最好看的电影了.	正面	正面
剧情比较老套，看在主演的份上打的分  除了😂 笑点还是可以的，但不过剧情都可以猜出来	负面	正面
题材新颖，搞笑段子挺多	正面	正面
会哭的，很悲伤	正面	正面
非常搞笑哈哈哈哈，这边第二次来，环境非常好	正面	正面
蛮好玩波搞笑	正面	正面
特效不错，笑点不很密集但挺自然，情节有些感人	正面	正面
对于喜剧片来说非常成功  后半段的剧情也还好	正面	正面
电影很好，开心麻花给出的惊喜真的不断，这部是灾难片，在灾难面前苦中作乐，比较有创新	正面	正面
好多爆笑场景很好看	正面	正面
没有什么意思、这叫喜剧电影吗	负面	负面
好困 浪费两小时 以后再也不看开心麻花的电影了	负面	负面
无论看多少次，还是会觉得好看、搞笑和感动。😄😭（我妈说泪点低就别总看这些剧，纸巾都被我用完了🤣） ​        这个世界上有这样一种人，普普通通是他的人设，碌碌无为是他的日常，但是在关键时刻，他们总能挺身而出，逆向而行……        小时候常听大人说，人死了会变成天上的一颗星星，我不想变成星星，因为那样就离我想见的人太远太远了。 ​        我努力地活着，就是为了重新回到你们身边，回到——你的身边。         我的肩膀背得起银河的重量，却背不起你一滴泪光。         马蓝星，带我回家…… ​        宇宙这么大，我们还会遇见。                                    ——《独行月球》🌕🚶🏻‍♂️	正面	正面
🌟 推荐可以  😊 演技超棒  😂 笑点哪哪都是  📚 剧本不错！	正面	正面
电影真的很好看，搞笑➕煽情，还可以，都不会给人俗气的感觉。	正面	正面
非常非常失望	负面	负面
本以为是喜剧，结果看着看着就哭了	正面	正面
笑点很多，含腾量极好	正面	正面
应该挺好看，不过我太困了，睡着了	正面	正面
逛街逛累了，非常适合来这放松休闲一下	正面	正面
很好，感觉很不错。	正面	正面
剧情特效都不错	正面	正面
比想象中的好看，就是没想到独孤月尽然牺牲了。 刚子极限好，很喜欢！！	正面	正面
剧情好看，很有笑点，沈腾从来不会让我们失望	正面	正面
个人觉得非常好，前半段特别开心，结尾还泪了。值得电影院看一回	正面	正面
。。。。。。。。。。。没怎么你上课睡瞌睡看看刷卡看手机记得记得就到家	正面	正面
垃圾电影，浪费我时间，看了半小时离场	负面	负面
周末和小宝贝开心一下午不香吗	正面	正面
凑合吧，还行	正面	正面
很久没有电影能让我真心笑出来了，搞笑又感动，很棒的电影	正面	正面
挺好看的，可以去看看	正面	正面
好看，很搞笑，最后挺感人的，有沈腾的电影必须追啊	正面	正面
剧情非常棒，很符合主标题，画面质量也非常奈斯！	正面	正面
还不错，喜欢沈腾和马丽组合	正面	正面
笑点还是挺多的。宣传个人英雄的情节，虽然比较矫情，但还是哭了。但是，很不爽的就是这种，上分钟还笑着，下分钟又想哭，这让人很难受，就像吃甜中带咸的东西，真的很不爽	正面	正面
搞笑，特效也不错	正面	正面
很好看，超级喜欢麻花的电影	正面	正面
剧情太好哭了！但又很好笑！！沈腾演技真的很牛！呜呜呜呜最后哭麻了	正面	正面
具体一般，还可以看，主要沈腾搞笑	正面	正面
搞笑不是很好笑，情节也有点不怎么符合现实。但是整体还是不错的，看起来也比较感动。但是水准不是很高	正面	正面
有泪点有笑点，剧情紧凑好评！	正面	正面
太好看了吧虽然价格不便宜，但是绝对物超所值，现在能找到这么好的地真的不容易了虽然位置有点难找，但胜在人少，没有嘈杂的环境，整个氛围非常nice，不错子😁	正面	正面
值得刷第二次	正面	正面
真精彩真精彩	正面	正面
前面剧情还好，后面就感觉像是硬加的戏。冲着马丽和沈腾去的，一般般吧	负面	正面
非常喜欢👏👏	正面	正面
还是比较值得去看的	正面	正面
这电影真的好！！	正面	正面
有笑有泪，还是蛮喜欢的。	正面	正面
超级好看！超搞笑	正面	正面
挺好的，没有吐槽的这么差	正面	正面
太多不符合逻辑的情节，尬笑尬感动，不笑硬咯吱的那种😂	正面	负面
挺好看的，也很搞笑	正面	正面
很搞笑  最后有点感人！！！	正面	正面
🉑值得去看。	正面	正面
我的评价是非常满意。	正面	正面
剧情很好看，但是电影院不怎么样，我们找工作人员拿毯子，说是会送来，知道电影结束都没有拿过来🙄	负面	正面
天马行空，还可以，小孩子都比较喜欢！	正面	正面
不咋好看，也不咋好笑	负面	负面
沈腾厉害👍	正面	正面
还不错可以了	正面	正面
很不错，喜剧的结尾总是悲剧	正面	正面
超级大奖等你下班把喜不喜欢会大喊大叫你	正面	正面
这部剧挺值得去看的	正面	正面
有笑有泪 非常值得！	正面	正面
看着可以，清晰	正面	正面
好好看，也好好笑，值得一看。	正面	正面
“马蓝星，带我回家”真的泪目了，时隔7年，沈腾马丽再次组合，真的非常非常棒 🌟 推荐	正面	正面
看了这么多电影第一个有真正提到一个职业提到 《钳工》	正面	正面
真的是，喜剧里面科幻做的最好的，科幻里面喜剧做的最好的，笑泪了	正面	正面
剧情很好，又感人又搞笑，情怀很深	正面	正面
开心麻花还是一如既往的保持了其高超的水准，剧情节奏不错，笑点也挺好的，就是部分想煽情的地方看起来会有点小尴尬，个人觉得沈腾和马丽的感情线部分放在一起会比较好一点，现在这种安排看上去还是有点小尴尬了。总的来说，是一部很好的喜剧电影，能够让你开心起来，但是结局嘛，有点小刀，但是不影响前面的观影体验。	正面	正面
真的很好笑也很好哭	正面	正面
没想像中的搞笑，剧情还是好玩，评分觉得有点过高，8.58.8差不多	负面	正面
好看，值得推荐	正面	正面
漫画改编的，片头片尾有融合动漫特效，做得不错挺可爱的，月球上的效果，大袋鼠也都做得挺好的，比很多玄幻电影的5毛钱特效好多了，没有让我出戏反正。笑点一般，没事杀手不太冷静那么好笑，但是泪点挺多的，我是个笑点泪点都很低的人，看到独孤月说马蓝星带我回家那段，我抱着女鹅哭得稀哩哗啦的😭谁跟我说这是个喜剧的啊，哭得我…很喜欢几首配乐，都非常好听，插曲印象最深刻的是摇滚版内首什么“zhei破地儿咱再也不待了、刚子咱回家”啥的，很好听，很带感，歌词带入感很强👍片尾好像是Coco唱的？我心目中华语唱跳女歌手一姐，没有之一，好爱噢，好好听！一个无父无母无友的社恐，高级工程师为离暗恋的人更近宁当维修工，默默无闻到女主甚至从不认识他，他内心戏却演了180集😂我有友女是酱紫，所以比较能共情吧…被独立落在月球，独孤月还是孤独月来着？这名起绝了🤣他的女神马蓝星，蓝星——就是地球吧！从直播他的生活，面对一个个困难勇敢地解决、重建返回舱，他记地球上的幸存者们重燃希望；到他以为爱人已死，正准备自我了断，地球上因他重燃希望的人们为他点亮了希望的灯…从金刚鼠揍得他满地找牙，到他冒死调头去救金刚鼠，互相救赎哭死我😭	正面	正面
很值得再刷的一部电影，满分	正面	正面
还行，不好不坏，平平常常	正面	正面
详情见豆瓣评分	负面	正面
剧情生硬，也就特效还行	负面	负面
可以，蛮搞笑的	正面	正面
剧情中规中矩，画面不错，演技在线，看到了不一样的沈腾。	正面	正面
好看啊，前面搞笑后面感人	正面	正面
还可以效果不错	正面	正面
很好看，搞笑又感人	正面	正面
又搞笑又感人的，很好看 推荐推荐推荐！！！	正面	正面
太好看了感人	正面	正面
值得一看，挺欢乐的	正面	正面
太好了，真的很不错，，满分电影	正面	正面
挺好看的，值得去看看	正面	正面
这个价格跟其他平台比起来真的划算太多了，而且环境、卫生各方面都不输其他家，真的必来	正面	正面
不错😄实力派	正面	正面
笑点五个，结局能猜到	正面	正面
就很好看啊 有笑有泪 不错的哦 推荐和小伙伴一起去看 互相拍腿大笑 互相递纸擦泪😂	正面	正面
不明白会有那么高的评分，	负面	正面
含腾量满满，10086个赞	正面	正面
好看  沈马出品	正面	正面
剧情一般，表演有点浮夸，笑点一般，看看还可以。	正面	正面
确实是不错的电影。影院里笑翻了。开心麻花的一贯风格。全员表演在线。	正面	正面
之前看网上很多黑的，就没有抱太大的希望去看，所以意外觉得还不错，有笑点有泪点，对于一部漫改电影来说，已经很不错啦！希望无脑黑的都留点口德吧，毕竟包括“袋鼠”在内所有演员的演绎都真的不错👍	正面	正面
带孩子看的，	正面	正面
超级好看，值得看	正面	正面
剧情内容煽情过曝，喜剧度没有以往作品高，但沈叔叔演技的确可以	正面	正面
宇宙难么大我们还会遇见	正面	正面
说实话没意思。但奔着神马组合给两星。爱情片不像爱情片，灾难片不像灾难片，喜剧片不像喜剧片。笑点有点低	负面	负面
很好看，很久没有看过能让我安安稳稳在电影院做两个多小时的电影了，好评好评	正面	正面
看着一般  也有催泪部分	正面	正面
非常好。	正面	正面
超级棒  超级好看	正面	正面
还可以吧，最后有点悲剧	正面	正面
我老公在我左边笑的哈哈哈，我儿子在我右边哭的哇哇哇，我在中间很为难啊。	正面	正面
没有想象的那么好，金扫帚奖提名。	负面	正面
前期制作版本就接触过所以可能有点先入为主，但是最终版看的时候有些词有些料有些衔接的段子要么改了要么剪了就挺可惜，为了时长吗？反正牺牲有点大，后面真应该再出一个加长版 画面很好，有些地方音乐配的不好有些嘈杂喧宾夺主了，后面感情戏处理的不错。 有麻花有视效有故事性，期待未来有更好的作品	正面	正面
还是挺好的 总体还行	正面	正面
非常好看，，，	正面	正面
把我看困了 来来去去就这些剧情 来来去去就这几个人 不出意外的话 意外就来了 真的没啥意思	负面	负面
好看，全场最佳刚子	正面	正面
好看的很，nice	正面	正面
😊 演技  🌅 画面  😭 哭点  😂 笑点  ✨观影贴士  📚 剧本  🌟 推荐 非常满意的一次体验生活了，很好看的电影，看哭了，看笑了，哈哈哈	正面	正面
🌟 推荐 沈腾出品，必是精品。  😊 演技 演员们的演技全员在线。  😭 哭点 开始有多搞笑，最后就多伤感！影片的最后，腾说：“马蓝星，带我回家。”看到这里都不自觉的伤心难过。 沈腾和马丽的组合确实是票房的保障。	正面	正面
还不错，挺搞笑的，电影院就是适合睡觉，，看着睡着了哈哈哈	正面	正面
沈腾电影没让我失望过	正面	正面
剧情很好，看画面很不错，就是剧情有点长	正面	正面
看的挺感动的也很搞笑	正面	正面
一般情况下的时候	正面	正面
很一般，但观众都笑了的，包括我也笑了，但总体就很一般，抒情的地方我一点也不觉得感动，甚至有点无聊，只有笑的部分比较好看	负面	负面
都很棒，前面笑点很多，后面让你😹	正面	正面
中国电影，我看行！	正面	正面
爱情的基础点，平淡而又不平淡的生活	正面	正面
独孤月是马蓝星的 刚子是全世界哒🦘	正面	正面
还可以吧………	负面	正面
好看，特效真的好，然后沈腾地方也搞笑，中间有段感动哭了	正面	正面
还可以 搞笑的时候很搞笑 严肃的时候也严肃	正面	正面
很好的动画片，小朋友看的很开心。文化水平不高、笑点低的人应该会喜欢。没有**谁的意思，看完后的客观评价。	负面	正面
隔壁的可爱女生一直在笑，好看好看	正面	正面
垃圾片中的战斗机	负面	负面
值得一看 yyds	正面	正面
特别好，有趣，有内涵	正面	正面
还行，特效有点假了	负面	正面
剧情还行，有点太跌宕起伏了，最后的结局虽然在意料中，但是也不想看到。	正面	正面
很好看！值得推荐	正面	正面
挺好笑的也挺感伤的	正面	正面
沈马组合票房担当，周五下班愉快看一场电影，缓解一周的疲惫。	正面	正面
还行吧，哈哈哈	正面	正面
剧情挺好，好搞笑哈哈！	正面	正面
搞笑，剧情也不错，好看	正面	正面
前面两次滑落两行清泪，最后的彩蛋却让我泣不成声，马丽最后看见独孤月哭的情绪真的好心碎。好喜欢马丽沈腾的cp，希望他俩一辈子都能守在彼此身边，无论是什么身份什么关系。	正面	正面
不给我一个人播放，浪费了2次，电影票钱！	负面	负面
别看，烂透了，浪费钱	负面	负面
一般话消磨时间	正面	负面
很搞笑，非常搞笑	正面	正面
很好看！有笑点有泪点！	正面	正面
还不错，他俩的戏	正面	正面
挺好的，搞笑的。	正面	正面
别**人了 含腾量100%都没用	负面	负面
好很好挺好看的	正面	正面
一般，中规中矩吧	负面	正面
电影不错，就是这个电影院不行，电影都还没结束着急下班就直接关了	负面	正面
一般，没以前拍的好看	正面	负面
笑点少  剧情一般  别太期待了	负面	负面
剧情一般，笑点不断。	负面	正面
期望很大，失望越大 ！诈骗，妥妥的电信诈骗	负面	负面
剧情还行吧。为什么刚下单的就不能退款了	正面	正面
啼笑皆非的一部好剧～以前看沈腾，觉得他这人自带喜感，哪怕站那儿不动，我都觉得很搞笑。这部剧里他也使我非常感动。整部剧一会儿流泪一会儿笑的。整部剧紧紧的带动着观众的情绪。值得推荐。	正面	正面
垃圾，总共就预告片里那么多笑点，别的片段就是在强制煽情，我也不知道男女主就没说过话哪来的爱情？！或许我真老了？理解不了中年人的爱情？！	负面	负面
好看好看，搞笑得很	正面	正面
画面质感很棒，演员演技也非常好，谢谢所有的演员给我带来的这部作品。	正面	正面
不错快去看	正面	正面
不错👌值得一看	正面	正面
看过的沈腾的最差的片子，没有之一	负面	负面
真的又搞笑又感动，袋鼠刚子的加入很特别，比加入某个配角人物都好！！！	正面	正面
很好的，演的很真诚	负面	正面
前期笑点密集不生硬，后半段哭死，彩蛋我还不死心期望有个奇迹🥹	正面	正面
太夸张了！！！	负面	负面
电影有搞笑的情节，也有感人的情节，影院人员爆满，腾哥的电影就是好看	正面	正面
值得推荐！！！！	正面	正面
好看，科幻喜剧，沈马组合依旧动人，这一部我终于get到了马丽的美（以前很喜欢她但不觉得她很漂亮），以及腾哥真的不考虑减一下肥吗，你可以更帅的哈哈哈	正面	正面
话不多说，快去看	正面	正面
只能说还行。	正面	正面
很好看，超级喜欢沈腾！	正面	正面
60亿没问题	正面	正面
蛮好笑的，沈腾太好笑了。	正面	正面
图一乐就看看，老梗和细节有点扯，剧情没什么好说的，模仿达蒙的电影	负面	正面
剧情十分的好看想二刷了	正面	正面
就很好看，影厅里的人都在笑	正面	正面
跨时空恋爱啊	正面	正面
挺好看的 “马沈组合”永远不会让我失望😎	正面	正面
想和你看每一部喜欢的电影	正面	正面
好看，不是那么搞笑，有点悲伤，后劲有点足，看完电影出来骑车一直在想剧情，总体很好看的。	正面	正面
赞不是圆满大结局的结局	正面	正面
这根本不是个喜剧片，我以为是《这个杀手不太冷静》类型的。 不错不错，科幻片整得挺好	正面	正面
真办事！！！	正面	正面
一般，可以看。期望不要太高。	负面	正面
又好笑又无聊 又感动 最后超级感动  视觉大片 视觉效果很好 “马蓝星 带我回家”！！！超感动	正面	正面
挺不错的，值得推荐	正面	正面
确实搞笑，但也仅仅是搞笑而已	负面	正面
值得推荐的一部剧	正面	正面
说实话 这部影片是沈腾拍的目前为止最尬的一部 也是最烂的一部吧 失望 不喜欢	负面	负面
内容非常棒，好搞笑，也很感人。大力推荐大家观看，也可以亲子观看。	正面	正面
有笑点，有泪点，光永远指引着人类。	正面	正面
电影非常好看，很搞笑。支持开心麻花！加油！	正面	正面
诙谐搞笑又感人，非常值	正面	正面
有笑点，有泪点，再一次没让人失望。	正面	正面
演到我的心巴上了	正面	正面
电影非常好。	正面	正面
好看！值得推荐！	正面	正面
挺搞笑的，还不错。	正面	正面
不是爆笑片，但是片子质量不错	正面	正面
全程爆笑，全程好评	正面	正面
不错不错！不愧是长在我笑点上的男人😂😂😂😂	正面	正面
好看好看！有笑点有泪点	正面	正面
非常好，沈腾的电影永远是惊喜	正面	正面
好看好看，支持国产剧	正面	正面
又好笑又好哭，推荐	正面	正面
笑着笑着就哭了，很不错沈腾马丽组合没让人失望过	正面	正面
开心麻花💓💓💓💓就是开心😃	正面	正面
个人觉得不好看，剧情不好，笑点牵强。	负面	负面
挺好看的，最喜欢袋鼠啦哈哈哈	正面	正面
整体很电影节奏，但细节有些经不起揣摩，感觉主体还是搞笑为主了，不过可以去电影院看，独自感觉不是能太开心，沈叔叔的这部电影还是多人去看比较开心。电影画面部分有出彩的地方，不是3D效果，所以座位和荧幕不用太挑~整体有起伏，不算很平，大袋鼠揍沈叔叔真的好搞笑啊🤣🤣🤣🤣🤣🤣🤣🤣🤣	正面	正面
行挺好的你看看	正面	正面
剧情还可以，当个喜剧看还是不错的	正面	正面
真的好看！！！！！！不亚于腾哥那几个。真的好看！！！！！！！！！强烈推荐，可能需要备点纸巾，有血有肉，有泪，最后没能回来说那么一句我喜欢你，有点遗憾，但是不可否认是个好片！！！	正面	正面
太好看了！搞笑的同时又很感人	正面	正面
第二次看陪小妹，特别好看	正面	正面
挺好的，感动	正面	正面
还行吧，剧情有点无厘头，但还是挺好笑的	正面	正面
还行，就是有点费纸	正面	正面
有沈腾的电影还是蛮不错的，袋鼠谁演的	正面	正面
太好看了简直	正面	正面
值得看，拍的很好的一部电影	正面	正面
不行，是个烂片，被骗了	负面	负面
一言难尽 啊	负面	负面
很不错，一直觉得是搞笑片，但是后面也是挺有故事的	正面	正面
很好看，题材新颖，老演员就是老演员	负面	正面
还可以，值得观看	正面	正面
剧情很感人，很励志，好看	正面	正面
只要沈叔叔的剧我就喜欢哈	正面	正面
开心麻花的一贯风格	负面	正面
爆笑，感人值得一看	正面	正面
可以可以很不错	正面	正面
真的挺不错，差点就信了评论不去看！这票房和评分其实已经是个证明！	正面	正面
值得看一下。中间人，也是做人的道理。	正面	正面
很好看，推荐一个	正面	正面
剧情波澜曲折，特效也是顶级，好玩，好笑，伤感，悲壮。	正面	正面
太好看了，最后直接升华了	正面	正面
挺好的，主要是地球人憋疯了，能进影院都挺好	正面	正面
很好看，有很好笑的段子	正面	正面
笑点是有的，不能打包票说超级好笑，毕竟每个人有不同的观点。但是这部电影真的很感动，也会带来很多的思考。英雄落幕，笑中带泪，虽然他的每一步甚至是结局都在意料之中，但巧妙的设计和包袱却让人有耳目一新的感觉，能感受到导演和演员们用心，今年最喜欢的喜剧片，演技打100分。	正面	正面
很好看，笑点多，也很感人	正面	正面
还是蛮幽默的	正面	正面
前期好笑，后期感人，剧情精彩	正面	正面
搞笑的点还是挺搞笑的，就是笑点集中在后期，前期很平淡，一般吧，想开心还是可以一看的	正面	正面
沈腾的电影都可以，有内涵，国产科幻片越来越进步了，满分吧	正面	正面
值得一看，十分推荐！	正面	正面
很喜欢，搞笑！	正面	正面
有笑有泪，非常喜欢。	正面	正面
剧情不错😄	正面	正面
仁者见仁，智者见智。我觉得挺不错的很有正能量	正面	正面
挺好的，还可以	正面	正面
挺好看的，搞笑也有一点，更多的是感动😹	正面	正面
总体还可以，就是逗玩	正面	正面
我觉得这个剧真的非常好	正面	正面
我们以后肯定能好多人登月！我希望我有机会看到，科学加油航天加油	正面	正面
还是比较搞笑的，最喜欢那句普通人在关键时候会冲在正确的位置，突然想到疫情逆行者。	正面	正面
好看 喜剧感很到位	正面	正面
本来前边都挺搞笑的，越看到后面越要结束的时候就感到挺悲伤的，这是我看过的开心麻花的电影里最不像喜剧的喜剧电影了。	正面	正面
剧情很好 画面太美了	正面	正面
影片超级棒！笑点多多	正面	正面
影片很赞！！！	正面	正面
很好 推荐看看	正面	正面
不错大家可以看看	正面	正面
感人的喜剧 不错 🌟 推荐  😭 哭点  😊 演技  😂 笑点	正面	正面
挺不错的，有笑点有泪点	正面	正面
剧情又温馨又搞笑	正面	正面
沈腾怎么能最后死了昵，啊，啊，啊，啊	正面	正面
推荐推荐，，	正面	正面
喜欢沈腾的可以看看，刚子很出镜	正面	正面
超级超级好看，妥妥的又喜剧，又感人 🌟 推荐	正面	正面
看了半场就走了，你说好看不？	负面	负面
剧情非常搞笑，沈腾马丽宇宙级浪漫，结尾的转变有点伤感，真希望他们能在一起，推荐大家去看一看。	正面	正面
你真的可以永远相信开心麻花，每部电影都有温度，细节环环相扣，这个片子哭了笑了，印象最深刻的是希望太阳永远不会下落，因为夏洛特烦恼。插曲也都很有感染力，共情力极强。美中不足是没有我喜欢的魏翔，但是腾含量很高，以至于最后我还期待地球十年月球一年，独孤月说不定还活着，跟马蓝星在月球上演一场星月神话💑	正面	正面
含腾量很高，笑点也还好，制作很精良。 缺点就是有些笑点很容易就被猜到，其次这部缺少了以前开心麻花作品的深度，这部就是纯纯搞笑，不过喜剧吗搞笑就完了，整体也还是不错的！	正面	正面
不错，好看……	正面	正面
前面部分可以，后面结局不咋地	正面	正面
心酸又感动~	正面	正面
画面很有美感。剧情幽默感人，，最喜欢的沈腾和马丽演技超赞！值得推荐的一部影片！让我们学会在困境中坚持，找出一线生机！	正面	正面
搞笑中有那么一点感人呐！	正面	正面
很好看！一开始笑的要死到最后哭的稀里哗啦 一定要看完最后彩蛋 直接升华整个影片 “宇宙这么大 我们还会遇见”😭	正面	正面
非常好，影片很搞笑，也很感人。	正面	正面
又感动又搞笑 棒极了	正面	正面
沈腾加马丽，开怀大笑就对了	正面	正面
好看，好玩，感动	正面	正面
好看好看，你可以永远相信开心麻花	正面	正面
很好很不错非常喜欢	正面	正面
好看。第一次自己一个人看电影。取悦自己。 笑了哭哭了笑。等彩蛋呢，我以为在最后，结果，前面那个就是。总之是等到了最后。	正面	正面
好，好看，值了	正面	正面
沈腾和马丽的独行月球剧情搞笑值得一看！	正面	正面
好看，不错，沈腾的电影一般错不了	正面	正面
好感人，尤其是独孤月和金刚鼠相处	正面	正面
还不错，开心麻花一直很好看	正面	正面
还行吧，喜剧就别动不动煽情了	正面	正面
就没有夏洛特烦恼的惊喜，有几个场景比较好玩，BGM🉑，其他的搞笑有点尬。。。 总体一般，可以看看。	正面	负面
很搞笑 全程都很搞笑	正面	正面
不好看，期望太高了	负面	负面
一般般  没啥剧点	正面	负面
没毛病好的狠	正面	正面
看样子夏洛特烦恼是天花板了，这部戏有点失望，有点太扯，扯的也不搞笑。	负面	负面
沈马死磕 🌅 画面	正面	正面
好看挺有意思！	正面	正面
不愧是沈腾啊	正面	正面
一般般……看睡着了。	负面	负面
含腾量的电影。必须最棒。最后为了所有人。牺牲自己。大爱，好喜欢😍	正面	正面
笑点尬，科幻不足，一般	负面	负面
很搞笑 画面也很好	正面	正面
说实话这剧情真的一般般，也就冲着沈腾去了	负面	负面
笑着笑着就哭了，哭着哭着就笑了	正面	正面
烂剧情 看一半就坚持不下去走人了	负面	负面
剧情太棒了，看之前一直听说不太搞笑，只有看了才知道，非常好看，一直会支持马丽跟沈腾的电影，超级推荐哦！	正面	正面
蛮好看的沈腾马丽就是很OK	正面	正面
大烂片，太难看了	负面	负面
前面挺好笑的，后面很一般，	负面	正面
太好看了吧，真的非常好看的一部电影	正面	正面
非常完美。万达电影院一直很细心	正面	正面
整体很是不错，从笑料不断到引人思考，从小的反转到大的正能量，而且含腾量着实很高，值得观看。	正面	正面
还行还行，挺棒	正面	正面
太好看 今年看的最棒的电影！！	正面	正面
挺逗的，特效也不错，节奏很好	正面	正面
很感人，很特别，腾哥一个人演出了一种人类在命运面前的坚持和毅力，其中也不乏有笑点，很推荐！	正面	正面
特效还可以，音乐还不错	正面	正面
真的很好，不愧是麻花的电影，点灯那一段真的很好哭，但是孤独月被袋鼠打那一段也真的很好笑	正面	正面
看了绝对不会后悔，袋鼠演技炸裂	正面	正面
看不下去，第一次看电影看跑	负面	负面
不错，画面感强	正面	正面
天马行空，开心麻花	正面	正面
没去看，看过一遍了	正面	正面
还不错，对于喜欢看宇宙的我，这部电影喜剧科幻，看着看着不由的想起现在在太空的那三个宇航员👩‍🚀	正面	正面
感谢腾哥带来的快乐！正能量	正面	正面
太好看了，搞笑和感动并存	正面	正面
不错，终于用点心制作了	正面	正面
笑中带泪，笑还哭！好喜欢！	正面	正面
还可以只是没想到是be结局	正面	正面
好，真的好看	正面	正面
太好看了，期待下一次	正面	正面
不要在地球上随便打手电，免得惊到月球人 当观众是没智商啊 不好看，不要看，不要看。 水军刷得分吧	负面	负面
剧情还可以，画面不错！值得一看！	正面	正面
不想给满分，但是的确忍不住，离星爷还有一定距离，故事反转，演技不错，爆笑的包袱比听相声还过瘾！不错不错	正面	正面
非常好看，特效不错	正面	正面
好看的，，，	正面	正面
还好，没想像中′的好厶看，朋友推荐说丶好看，特意去看看力也就这样吧	负面	正面
全片看完，感觉实在很一般，故事线乱，笑料少强行煽情，真不值票价	负面	负面
笑中有泪点，真优秀	正面	正面
根本就不逗乐，没啥意思！说意思的笑点得多低啊！	负面	负面
我本人就喜欢沈腾马丽，更主要他们拍的片子都很好看～这部片也不例外～	正面	正面
看着还可以，挺好看的	正面	正面
棒极了，完美	正面	正面
好看，但是不喜欢喜头悲尾的剧情设计。最后月对星说的“带我回家”莫名代入了小哥 就更悲伤了😭	正面	正面
可以可以 好看	正面	正面
还得是沈腾马丽！！！！！	正面	正面
搞笑的，可以去看看	正面	正面
看哭看哭了，沈马太好磕了呜呜呜最后还幻想独孤月不会牺牲，啊啊爱了	正面	正面
我真的觉得一般般一般般 可能不适合我	负面	负面
好看的不一样	正面	正面
剧情很不错，题材也很棒，里面的笑点也挺多的，欢乐和感性交织并存，让我印象比较深刻的片段是独孤月在被全球直播时，镜头播出去的却是赤大袋鼠“刚子”，以及二者的生动互动与“亲切问候”的画面。还有就是独孤月在打开宇航服时，看到地球上的人们为了给他继续活下去的希望，纷纷用手电筒照向太空，在黑色的地球表面组成“你不是人”的字样，让原本被感动的眼泪在疯狂打转的我顿时破涕为笑！另外我是带着妈妈一起来看电影的，妈妈也很喜欢！很棒的观影体验！	正面	正面
很不错，挺有意义的	正面	正面
挺好看的 搞笑 感动 正能量	正面	正面
这是一部属于沈腾的独角戏，电影里面非常多沈腾式独特的浪漫。 独行月球，独孤月跟金刚鼠之间的互动非常有火花，真的非常可爱！ 整部电影的笑点也是非常多 开心麻花的各个演员都非常搞笑可爱！ 马丽饰演的马蓝星在最后跟独孤月的相遇也是非常唯美！ 很不错。值得看！	正面	正面
不知道要表达什么 很扯很离谱 有轻微但很勉强的笑点和泪点  感情线很尬 没有感情线还能再高两颗星	负面	负面
非常搞笑，但是也非常感人，就是说很nice，好评，最令我震撼的一部电影	正面	正面
我爱刚子！！	正面	正面
剧情挺好¥j	正面	正面
🌟 推荐 个人觉得挺好的 不像网上有的说的那么不好。笑点基本都笑了，后面也挺感人的 推荐👍👍👍👍👍	正面	正面
垃圾片，老梗，恰冷饭，视觉疲劳	负面	负面
非常棒，值得观看	正面	正面
一般不怎么好看	负面	负面
中国电影崛起 剧情搞笑诙谐 感动 值得一看	正面	正面
还行还行六个字	正面	正面
挺好看 搞笑感人	正面	正面
又笑又哭，很值得一看	正面	正面
真的还不错	正面	正面
还不错的啊啊啊啊我	正面	正面
挺好的，喜剧	正面	正面
好，值得观看	正面	正面
很好看，推荐 ！	正面	正面
值得一看，良心推荐。	正面	正面
很差，不推荐	负面	负面
沈马从不辜负观众！	正面	正面
第一次在中百看电影，很喜欢，电影也好看	正面	正面
挺好的，前年搞笑，后面感动， 唯一不喜欢关于本人的喜好，不喜欢机械东西多，和灾难类型，情绪紧张，精神一直会紧绷着	正面	正面
有一段沈腾开车飞起来那个画面让我想起了他另一部电影🎦飞驰人生   🦘有很多表情包   宇宙很美..	正面	正面
很好看，沈腾和马丽老搭档了。影帝沈腾实至名归	正面	正面
依旧是如此的让人捧腹大笑	正面	正面
好看，很好吃，很满意，下次还会来。	正面	正面
搞笑的同时，给人以视觉的震撼和共情的感动。 不愧是喜剧天团 以一人之力，捍卫了地球和人类的平安。非常感人	正面	正面
可以说很没意思，笑点全猜到了，st又一次让我失望了	负面	负面
还行吧还行吧😊	正面	正面
还行，没有预期的好笑	正面	正面
剧情反转反转在反转。好看	正面	正面
作为喜剧来说，不怎么搞笑，剧情比较一般，大概就是你看到开头就猜到结尾那种。最震撼应该就是后面半个小时了，沈腾在太空翻转那段，感觉特效还是很不错的，有被震撼到。烂梗，谐音梗太多，太老套，可能笑点在沈腾被袋鼠揍了？不清楚，因为没get到。不过灾难片，英雄主义表现力来说的话，还是可以的	负面	正面
满分推荐特别好看	正面	正面
难得的感人喜剧科幻片	正面	正面
电影很好看，值得推荐	正面	正面
蛮不错，值得推荐	正面	正面
我个人认为，这是一部很不错的片子，我不知道有一些人在喷什么-_-||	正面	正面
好看，又很感人	正面	正面
从四海到独行月球…信誉坍塌。	负面	负面
挺好玩的，既搞笑又感人	正面	正面
凑活吧。。。	负面	正面
含腾量挺高的	正面	正面
真的超级满意，根据推荐来的，省了自己慢慢做功课的时间，省时又省力，赞赞赞(˘͈ᵕ ˘͈❀)	正面	正面
还可以的，可以再进步一下	正面	正面
不好看。小品一样。	负面	负面
老沈的搞笑，不会让你失望	正面	正面
笑中有泪 沈马组合不会让人失望的。	正面	正面
冲我偶像沈腾来的	正面	正面
嬉笑中带着严肃，轻松中引发思考，人物的演技绝对杠杠滴，值得一看	正面	正面
非常好，很好看	正面	正面
环境不错，画面清晰啊，音质不错。	正面	正面
什么玩意啊，无聊到爆炸	负面	负面
奔着沈腾去的，失望，笑点太low，一星也是给沈腾的，毕竟夏洛特烦恼很爱～	负面	负面
这个电影不错！值得一看推荐	正面	正面
挺好看 值得去看	正面	正面
科幻，搞笑，很好看	正面	正面
看了三四遍。	正面	正面
还可以吧，比预期差一点点	正面	正面
真的失水准诶	负面	负面
很一般，吹过头了	负面	负面
剧情紧凑不拖沓，有幽默风趣又感人肺腑含腾量高就是不错	正面	正面
挺搞笑hou m	正面	正面
值得看，太搞笑了	正面	正面
好看，喜欢哦	正面	正面
眼前一黑，期待值太高的不用看了，跟开心麻花以前的电影比不了，又尬又俗，俗不可耐，睡着了又醒了又睡着又醒了	负面	负面
一直喜欢马丽的电影	正面	正面
烂片…没剧情…强行加剧情…无厘头袋鼠 强行加入剧情…总之一句话…剧情**…笑点也一般般…巅峰还是夏洛特烦恼	负面	负面
很好看，即好笑又感人，比夏洛特烦恼好看有内涵	正面	正面
好看好看，既搞笑又感动	正面	正面
没意思全程刷手机	负面	负面
不错，沈马组合！	正面	正面
挺好看的，感动和搞笑	正面	正面
剧情精彩，内容丰富	正面	正面
好看超级棒。	正面	正面
沈腾自己演戏不错，演刚子的演员很努力，加油	正面	正面
现在是2022年7月22号，我会一直等我喜欢的女孩子来和我去看电影，虽然很渺小，但我会一直等🍓	正面	正面
一般般，结局马丽跟沈腾站一起的时候，剪辑都能减掉沈腾的影子，那袋鼠的手指头你怎么解释啊，不穿太空服的时候是蹄子，穿了变手指，5个还都能动	负面	负面
打发时间可以看看	负面	正面
很nice！不仅有笑点，泪点也直逼人心！棒棒，力荐	正面	正面
卫生不好，场次没有进行消毒	负面	负面
很不错，既搞笑又感人	正面	正面
垃圾，笑点太土了，抒情也**	负面	负面
🌟 推荐 很好！	正面	正面
还可以吧，笑点挺多	正面	正面
全程睡觉，没什么笑点纯属浪费时间！	负面	负面
沈马组合 演的非常好看	正面	正面
挺好的  有笑点有泪点   今年算是不错的片子了	正面	正面
此片笑点没有以往沈腾的其他喜剧多，比如西红柿首富、夏洛特烦恼这两部剧，不过值得点赞的是他把科幻效果拍的有进步！	负面	正面
电影巨好看，特效做的很逼真电影情节反转意想不到，大结局是真的没想到，和小姐妹在影院哭崩，宇宙这么大 我们还会相遇	正面	正面
还不错😊 😁😁	正面	正面
太垃圾了，开心麻花一部接一部烂片，怎么还9.2，刷的吧！	负面	负面
真的一般，也不是很搞笑，看的都要睡着了	负面	负面
剧情搞笑中带有温情，是近期看到的好片	正面	正面
很好看，挺喜欢的。	正面	正面
实在是不好看	负面	负面
又哭又笑  很值得看	正面	正面
真好看真的太好看	正面	正面
沈腾的表演还是值得一看，故事性比较弱	正面	正面
很不错  前面搞笑 后面感人	正面	正面
真的很一般，旁边的笑得要死我也不知道有什么好笑的？开头真的很无聊..	负面	负面
笑中带泪真的很棒	正面	正面
挺好看的  总体环境很不错	正面	正面
挺不错的！！！！	正面	正面
超级好看，后面还带些感动	正面	正面
总体还是跟好的！尤其是特效相当好！相当用心！就是剧情有点参考火星救援！	正面	正面
剧情很好，非常好笑，支持！	正面	正面
好看好看非常奈斯	正面	正面
好看   女朋友一直笑到最后	正面	正面
真的不错好看	正面	正面
挺好。	正面	正面
好看，开心麻花永远不会让人失望	正面	正面
没办法看 没办法看	负面	负面
不用多说什么，看了的人都说好	正面	正面
挺搞笑的，喜剧么，笑就完事儿了	正面	正面
好看。。。。	正面	正面
很好看，超级好看，推荐推荐，笑点很多，也有泪点，感觉主题也很好	正面	正面
电影好看，就是屋里太热啦，一点不舒服，这大夏天的，屋里像蒸桑拿是的	负面	正面
很好看 前面很搞笑后面很感人	正面	正面
感觉一般化，没有那么意外	正面	负面
我觉得挺好看啊，后面的话有一部分比较感人的地方，可能有的人泪点高，有的人泪点低，泪点高的人觉得他在煽情或者怎么样，但是对于我来讲我觉得他没有，喜剧电影我看着挺开心的，那他就是喜剧啊，没有任何问题，而且家里老少都可以去看	正面	正面
还是一如既往的喜欢沈腾和马丽，	正面	正面
挺好看的 可以去看一下	正面	正面
全程平静且冷漠	负面	正面
真的挺好看，力推	正面	正面
很不错 挺好看	正面	正面
很好看，非常搞笑又感动	正面	正面
很多笑点，轻松愉快的氛围。 后半段男主把对女主的小爱化作守护全世界的大爱，十分感动。 是一部不错的电影。	正面	正面
真的很一般 为啥评分那么高	负面	负面
腾味十足 超喜欢	正面	正面
我想说一下实话 我真的蛮喜欢沈腾和马丽的 但是这部电影给我的感觉就是笑点不够 泪点也不够 都是浅浅一层 冲着沈马过去的 可能是我期望太多了 后面我感觉就是纯属硬造泪点 笑点是肯定有一些的 但是没有那么开怀 只能说一般般 建议大家不要有多大的期待 反正最后俩个小时的电影把我看困了	负面	正面
就还可以吧～	正面	正面
没想到能感动哭😭	正面	正面
因为特效多给了半颗星，搞笑不彻底正剧也不彻底，演员都演的挺用力的，就那样吧	负面	负面
还不错噢噢！	正面	正面
超级喜欢 推荐推荐	正面	正面
好看。一直有笑点	正面	正面
很搞笑又很感人	正面	正面
强烈推荐，超级好看！！！	正面	正面
不错的，值得一看	正面	正面
明明是个喜剧电影竟然be了。讨厌刚子。	正面	正面
还可以，沈腾怎么样都不会差其他的电影我一点看的欲望都没有这个没让我失望，不过看完我很难受，他的目的就是回到地球，看他女人，结果呢经历了重重困难，生死考验多少次，忍受孤独寂寞，最后还是得死，就是完不成自己的目标，我这个普通人就像看到他能活下来，经历了一切大团圆，我不想看到悲剧，是剧情升华了，但是我很难受	正面	正面
爆米花电影 还行	正面	正面
还不错…………	正面	正面
笑点不是很多但笑点都还不错 总体还行吧比预期要差点	正面	正面
前面确实挺搞笑的 但是后面很尬 有点强行泪点  特效不错 本来以为是全程笑到尾 结果后一个小时都能猜到结局了 总体7分吧  多一分给沈腾和刚子🌝 🌝 🌝	正面	正面
电影挺好的不错	正面	正面
店里很多设计我们都一致认为很棒，体验感非常不错，大家一定要来亲自体验一下！	正面	正面
很好看 有很多笑点 也有很多泪点 真的很好看！！ 🌟 推荐	正面	正面
太感人了，都给我去看😘😘😘😘😘	正面	正面
挺好看，国产科幻片在崛起	正面	正面
挺好看的，也是现实	正面	正面
非常棒，超级搞笑	正面	正面
好看，感动哭死了	正面	正面
还可以，前面蛮好玩的，后面就变成大爱拯救地球，壮烈牺牲，可以一看！	正面	正面
好剧，推荐。	正面	正面
很有意思，值得去看	正面	正面
极力推荐，好看	正面	正面
有笑点，有泪点，全程无尿点，笑着笑着就哭了，哭着哭着就笑了，科技感满满，正能量，好看，强烈推荐	正面	正面
前面笑哭，后面真哭，不错的电影，推荐推荐	正面	正面
还行，没有想象中惊艳	负面	正面
含腾量非常高，剧情也不错，值得票价！	正面	正面
喜剧中透露着感动感动，一个人撑起了一部剧，沈腾演技在线，值得一看	正面	正面
非常好看，很有鼓舞人心的感觉	正面	正面
反转多，值得看	正面	正面
孩子看了高兴的不知道姓啥了	正面	正面
我本来以为去看了个喜剧，结果没想到去看了个科幻剧。	正面	正面
马丽沈腾yyds	正面	正面
感觉一般般，我都没看懂什么内容，带侄子们感受一下看电影的感觉！	正面	负面
还得是沈腾拯救快乐	正面	正面
可以看，但感觉不是那种让人想看第二遍的电影	正面	正面
不错，整个片子含糖量比较高，然后搞笑吧，不是很高级，有点低级，但是毕竟不是社会片嘛，然后配着这个背景还可以，有点歇斯底里的搞笑，但是整个故事的意义非常好，就是虽然我们平了，但是我们的血有没有冷下来？就是大概这个意思	正面	正面
宇航服面具有一点假	正面	正面
电影还是不错的	正面	正面
你不是  个人	正面	正面
还不错挺搞笑的	正面	正面
已经很好了，笑点密集，多反转，有泪点，包袱密集无尿点。	正面	正面
为了躲雨去看的，挺好的，笑的头没了	正面	正面
很不错的片子。	正面	正面
很不错，挺好的。	正面	正面
🌟 推荐         都非常好，喜剧与悲剧交加，让我们看到了跨星球的浪漫🌹         其中，影片的开头和结尾都用“真是元气满满的一天啊”进行呼应，前者可以让我们感受到喜剧的感觉，奠定了全篇的基调，后者则作为收尾，让我们体会到了地球变好后的大众们的喜悦与希望之心。         我相信，独孤月的英勇牺牲是值得的，他终是用微笑来结束了自己的人生，一个有意义的一生。          宇宙这么大，我们还会遇见……	正面	正面
爆笑  真的很腾	正面	正面
不错吧，喜剧风格	正面	正面
先喜剧再悲剧，很有看头。	正面	正面
还行，主要是期待过高了	正面	正面
蛮好的，有笑点也有泪点	正面	正面
好看精彩搞笑	正面	正面
太好了电影，真的太好了，很喜欢这个，太好了，很喜欢。	正面	正面
太好看了吧啊	正面	正面
有基本没怎么笑	负面	负面
太好看了🤣🤣	正面	正面
一般吧，一般吧	正面	正面
亲爱的妹妹们，如果你们去看的话，记得带纸巾吖，欺骗了我很多眼泪，还是不错哒，值得观影。	正面	正面
比较放松的一部电影	正面	正面
故事没讲出故事，笑点也极低，根本就是一个拼凑出来的小品，无聊至极	负面	负面
不！好！看！	负面	负面
腾老师出主演必看，好看	正面	正面
搞笑又感人，必看影片，还足2小时长，值了	正面	正面
非常好看的电影，嘎嘎有意思	正面	正面
不推荐！不推荐！	负面	负面
看了这部影片，不得不说沈叔叔的演技确实好！！影片中有让人欢笑的场面，更有让人泪目的场面。舍小我保大我。独孤月在月球上待了900多天，他活着，他给地球人民带来了希望，我曾经梦想，飞向远方。当我迷路，总有颗星光。我的肩膀，背得起银河的重量。当天亮起来的那一刻。月亮上的叔叔，带咱们回家了。刚子！！！好好的！！！！我相信他一直都在，在不远的地方看着我们，在心中想着我们	正面	正面
很不错，演员也非常好	正面	正面
比较有意思，寓意也不错	正面	正面
太搞笑了!最后确哭了	正面	正面
剧情不错，搞笑煽情都很成功	正面	正面
好好看！我爱腾哥！！！我爱丽姐！！电影前半段很搞笑，后半段来骗我眼泪呜呜呜呜。每一个演员都好棒！！！	正面	正面
电影还行，影院太差了，前台服务差，问他什么都是爱搭不理的，好像去那里消费打扰他玩手机一样，网上买票的时候写的免费停车三小时，等问他们要停车票的时候，直接两个字没有，态度又差，没有免费停车三小时，网上为什么又写的有，这不是忽悠人吗，第一次来这里看，也是最后一次…	正面	正面
主角计划一直不顺 有感情线 但不多 前边很搞笑 到最后有煽情部分 很震撼 很感动	正面	正面
好看，很搞笑，很棒的作品，很喜欢沈腾和马丽这对cp	正面	正面
好看 好看！	正面	正面
好看，搞笑担当	正面	正面
很喜欢，前面搞笑后面感人	正面	正面
其实个人感觉就那样。笑点依然在。有的笑点好尬。剧情可能不是我喜欢的那种。	正面	负面
好看，笑点多！	正面	正面
看到40分就睡着了。	负面	负面
真的很不错，不像他们说的那样，好不好看，还真得自己去看看体验过了才知道，还好没信他们的，不然错过了！	正面	正面
没有想想中的那么完美	正面	正面
剧情什么鬼，学火星救援的梗还学不好，**	负面	负面
大反转虽然很多都不太切合实际但是就是好看	正面	正面
很无聊，全程就是一群专业的航空人员一天24小时，一共500多天的时间，围绕着某个被遗留在月球的人跑，很尴尬，不合常理	负面	负面
超级好看呀！	正面	正面
这个店还挺隐蔽的，看起来非常高大上，提前预订到了不错的位置，总体体验非常nice服务非常贴心一级棒，毛巾也是消过毒的，可以放心大胆用离地铁站很近，而且店里环境非常合我的口味，迅速赶来给个💯分！哈哈哈说一个细节，卫生间很干净，味道特别好，这个细节真的很戳我！！跟着导航特别好找，停车也很方便，上菜也很快，推荐！	正面	正面
可以的   又哭又笑的	正面	正面
剧情背景设定挺新颖 但笑点还是老套 希望开心麻花能够回到一六一七那几年的笑点质量	正面	正面
搞笑，感人，不烂尾	正面	正面
一般般，没有第一次吃的好吃，但是这个味道真的太好吃了，下次还会再来的。	负面	正面
好看，五颗星，推荐	正面	正面
剧情非常的感人与快乐！能够把搞笑和悲伤这两个相斥元素融合的这么自然，非常的厉害👍🏻，不愧是沈马黄金组合。 唯一一个不太好的就是关于电影的背景音乐，有些场景的背景音乐太过于大，把演员的说话声完全掩盖了，特别是有些搞笑台词，这是一点点的瑕疵！ 祝沈马电影票房大卖！口碑和票房双赢！	正面	正面
感觉比起开心麻花的其他电影来说 真的一般	正面	负面
特别特别好看	正面	正面
非常不错，超级推荐	正面	正面
适合全家一起去看的喜剧电影，剧情及搞笑片段不尴尬，情节也不复杂，	正面	正面
好看，搞笑+感动😭	正面	正面
袋鼠暴揍沈腾	正面	正面
大人看一般，孩子还行	负面	正面
真的感动！！	正面	正面
沈腾给我的感觉，看见他就想笑，这部独行月球及搞笑，又感人，还带有一点英雄主义的元素。总体还是很不错的，推荐大家看看。	正面	正面
，哦简直就像雨	正面	正面
都非常好，画质很真实，剧也很好很感人，非常值得推荐 !超赞的好吧。	正面	正面
超级好看好看	正面	正面
很好看的一部搞笑感染片，支持沈腾	正面	正面
很多笑点，想2刷	正面	正面
有笑点有泪点，整体还行，但有的地方有点尬	正面	正面
后面哭的我鼻涕眼泪一起流，太感人了	正面	正面
剧情好看，不是那种无厘头搞笑，有笑有感动	正面	正面
你提一下提醒就行	正面	正面
一部很励志的电影	正面	正面
很好看  孩子喜欢的不得了 真的是让我们笑抽了 感动的流泪了 沈腾演得也非常棒	正面	正面
麻花值得推荐	正面	正面
很好看 细节很到位	正面	正面
除了报看 其他都挺好的	负面	正面
整体一般，感觉想睡觉。娱乐娱乐还行……不是我喜欢的类型	正面	负面
特别好看，精彩	正面	正面
真的很搞笑啊！～	正面	正面
喜欢，对沈马粉来说是天堂。剧情当作合家欢喜剧看，前半段铺笑料、后半段转个人英雄主义式煽情，算比较典型的这类，但花三四十块去影院看我觉得是不亏的，电影画面做得很好，配乐很喜欢。	正面	正面
烂烂烂！烂大街了	负面	负面
原以为是个喜剧  看得感动哭死我了	正面	正面
行你了家哦破人认识	正面	正面
挺好看的，有笑点也有泪点。	正面	正面
喜欢推荐观看	负面	正面
还可以，下次还会光顾	正面	正面
这部电影超级好看	正面	正面
唉😔 说什么好呢？	负面	负面
挺不错，可以，不错不错不错不错	正面	正面
可以  也挺欢乐的  很喜欢	正面	正面
搞笑又感人，励志片	正面	正面
腾哥不愧为百亿影帝 沈马组合是永远的神	正面	正面
值得一看 推荐	正面	正面
一般般，实在没什么可看的，凑合看吧	负面	负面
总的来说还可以吧，	正面	正面
不按常理出牌，喜剧的结尾竟然是悲，我真的会谢	正面	正面
前面笑死  后面想哭	正面	正面
好看的呀，有笑有泪	正面	正面
沈腾和马丽主演的电影，主要的是开头半小时搞笑  到后面精彩了  还有结尾的时候，沈腾为了保护地球上仅存的人类决定牺牲自己，值得我们学习。	正面	正面
含腾量十足、喜剧的核心是悲剧	正面	正面
太垃圾了 毫无笑点	负面	负面
挺好	正面	正面
不好看，剧情太差	负面	负面
太好看了，没给我哭死	正面	正面
剧情中有搞笑部分，也有温馨的地方，有看到了一个人孤独的地方。	正面	正面
太好看了 全程搞笑高能	正面	正面
他说过不想成为星星，最后还是变成了星星	正面	正面
剧情说实话一般吧，前面很好笑是真的，但是后面感人的情节真的太生硬了，很俗套，非常容易猜到要发生什么，七分是给沈腾和马丽的，还是值得一看的。	正面	正面
你不是人哈哈	正面	正面
感动与笑点都有，不错的电影	正面	正面
好看，沈腾就是会演	正面	正面
含腾量十足，氛围很好	正面	正面
特别有意思，很值得去影院观看，效果特别好	正面	正面
你可以永远相信沈腾跟马丽！沈腾跟马丽的魅力和影响力绝对超乎你的想象！还有就是特别喜欢片尾的那一句：“宇宙这么大 我们还会遇见”！	正面	正面
钱花了    没去	负面	负面
不错，是沈腾近几年拍的片子里最好的	正面	正面
特别好👌🏻	正面	正面
太棒了，国产片演成这样，简直太给力了	正面	正面
😂 笑点还挺多的	正面	正面
非常满意，喜欢	正面	正面
剧情比较喜剧	正面	正面
剧情一般，节奏一般，笑点一般，强行煽情**人	负面	负面
两颗星，一颗给沈叔叔，一颗给马丽。 这部电影作为一部科幻喜剧片，不管在科幻上还是在喜剧上，说实话都很失败，沈腾马丽这样的喜剧演员都无法拯救的失败。 科幻上，简直是侮辱观众的智商，在基地里有***直播我勉强能理解，但是独孤月去拉宇宙之锤的时候哪儿来的***啊？难不成地球指挥无人机拍摄？更离谱的是，最后扛着核弹炸陨石……我沉默了…… 再说喜剧，两个字：尴尬。要不就是扮丑，要不就是色情低俗……对比一下以往的夏洛特烦恼、西虹市首富，再加上烂俗的结尾，强行感动，真的很不喜剧。	负面	负面
刚子，你不厚道 😊 演技	正面	正面
超级催泪，笑点也很密！！！	正面	正面
好看，我蛮喜欢的	正面	正面
总体笑点有点少。	正面	正面
剧情很搞笑 也很美好🤩	正面	正面
看了两遍，挺好看的	正面	正面
搞笑但不够经典搞笑。 煽情有，但不够震撼，没什么后劲。 特效，剧情，都离一部好电影有点欠缺。	正面	负面
很满意。搞笑不失浪漫	正面	正面
真的喜欢这对cp真不错	正面	正面
非常不错非常不错，沈腾就没有让人失望过	正面	正面
非常好看非常感人	正面	正面
电影很好看，画质啊特效也好爽，我真的好想扣两分给影院观影环境，叽叽喳喳打电话的，孩子说话闹得，进进出出的换座位的，但我不想让电影受这个气，真希望各位小朋友安静点，各位大哥也别让我听见您听歌了，您也别还没到时间结束就叽叽喳喳离场了	正面	正面
笑着笑着就哭了 该吃吃，该喝喝，有事别往心里搁！	正面	正面
很好，非常值得推荐	正面	正面
特效很逼真。	正面	正面
剧情很精彩，含腾量超高哈哈	正面	正面
好哈哈哈哈哈h h	正面	正面
非常好看😄	正面	正面
很好看，看的都没够	正面	正面
沈腾马丽从没有让人失望过	正面	正面
好看！ 有笑有泪，不错	正面	正面
🌟 推荐 好好看建议去看	正面	正面
挺好，不要考究喜剧片的科学性。一般喜剧的背景是悲剧，这戏不错。	正面	正面
现在电影评分都乱评吗？这电影真的很一般。真心话8.5分合适！	正面	负面
搞笑，很不错的	正面	正面
很喜欢沈腾和马丽的作品！继续加油！	正面	正面
含腾量百分百，沈腾真的是长在我的笑点上，他就不动坐在那都让我觉得浑身是戏。剧情跌宕起伏，前期电影院整个都是爆笑，每分钟一大笑是差不多的。后边感人的地方也不让人觉得尴尬，不会尴尬的说教，不错。非常想去二刷。	正面	正面
还行，！！！	正面	正面
特别好看，特别减压	正面	正面
很bi cuo	正面	正面
很励志的一部电影，讲述了独孤月与金刚鼠一人一袋鼠在月球上是如何回家的故事。在此过程中发生了许多意外，独孤月也总是能够以意想不到的方法去解决，虽然结局泪目，但其中有一幕是地球上的幸存者们用手电筒等照明物来点亮地球，让地球之光为身处在月球的独孤月带去希望之光！真的超酷的👍👍十分好评✊✊	正面	正面
含腾量百分之百果然名不虚传，全程无尿点，剧情非常好，结局也非常感动😁😁😁😁😁😁😁😁	正面	正面
很好看的电影，沈马无敌	正面	正面
感人！泪目！又有点搞笑！	正面	正面
爆笑，感人……	正面	正面
剧情超好！！看的人很共情！ 😂 笑点超多～超级超级值得一看！！	正面	正面
确实一般般，不推荐，看着途中就一直想 走	负面	负面
挺好看，值得推荐	正面	正面
跟男朋友去看的，我们都觉得挺好看的	正面	正面
最能代表的评价就是观众一边哭一边笑着高喊着喜欢地走出电影院。	正面	正面
非常👍的一部戏，让你又笑又哭，沈腾的演技不只是搞笑那么简单	正面	正面
既有笑点又有泪点，很开心麻花！	正面	正面
真的还可以！！！	正面	正面
演技很好，画质也很清晰  最后还挺感人的呢  全程都很搞笑  我从来没写过评论 大家可以下手！！！好看！	正面	正面
值得一看，再说多了剧透了	正面	正面
也不算是喜剧，唉。。。	正面	负面
挺好的电影，有喜剧，有感人！	正面	正面
确实不好看 营销的太过火 看完之后无敌失望	负面	负面
至少六个字少	正面	正面
不错！既搞笑又感人	正面	正面
特效不错，剧情也挺好，就是可惜最后沈腾没了	正面	正面
有点感人！！	正面	正面
开心麻花人员出品都没有差的，有笑点，泪点。画质感人。	正面	正面
好看，有搞笑也有感动，顶！	正面	正面
五星好评，继星爷之后又一个团队可以把喜剧拍这么好。	正面	正面
剧情紧凑，喜欢沈腾的可以看看的	正面	正面
好好好好还没	正面	正面
好看 强烈推荐哦	正面	正面
太棒了，只要有沈腾的喜剧电影就一定不会令人失望！ 好看、好看、好看，还想看第二遍！	正面	正面
还可以不错还可以不错	正面	正面
关于星辰大海，关于人性，我们之所以相信世间美好，是因为有爱去点亮心灵的光，每个人都是那可点亮星辰的萤火微光，因为心中有想守护的人，所以我们可以化作展翅的鲲鹏，去跨越万水千山，去承载山河大地！ 感谢麻花呈现这部笑中带泪的作品，现在的地球妈妈需要我们每一个人😘	正面	正面
可以推荐去看	正面	正面
提问，片中黄子韬的作用？	负面	正面
挺好看的，沈腾马丽组合，不会让你失望哦！	正面	正面
太感人了，值得一看	正面	正面
可以 可以不错	正面	正面
开心麻花出品，必属精品，反正我喜欢！有笑点有泪点。	正面	正面
nice含腾量极高	正面	正面
🌟 推荐很好看的一部电影，含腾量很高，欢乐与感动并存	正面	正面
一般安。。。	负面	负面
很感人呀 挺出乎意料的 本来以为是纯喜剧 真的特别特别的感人	正面	正面
含腾量很高的一部剧，包袱也多，但是最后这种结局一直让我很担心的感觉，没有笑出来	正面	正面
真的好看，又搞笑也有感动	正面	正面
笑点太少了 有失水准	负面	负面
非常可以 🌟 推荐	正面	正面
be了be了	正面	正面
好好好👍真好看	正面	正面
🌟 推荐 非常棒，非常满意	正面	正面
当成搞笑片看看还是很不错的。	正面	正面
🌟 推荐超好看  😊 演技爆表  🌅 画面新颖  😭 哭点感人  😂 笑点高级	正面	正面
笑声一片一片	正面	正面
剧情一般、不是很搞笑、演技还可以	负面	正面
可爱的刚子🦘，含腾量很高，很腾式喜剧，👍	正面	正面
特效不错，演技很棒，剧情也很棒，也比较搞笑，但是相对于西红柿首富喜剧效果还差点儿，整体来说特别棒	正面	正面
欢乐有趣，可以一看	正面	正面
失望，太失望了	负面	负面
含腾量高高的	正面	正面
感动大于搞笑，可能是期待值过高。	正面	正面
还可以，勉勉强强！	正面	正面
感觉 没有预想的那么好看	正面	正面
我感觉挺好看	正面	正面
可以  还不错	正面	正面
含着泪的笑，你体验过嘛？莫名的燃和感动化成了漫天繁星，终极浪漫😭	正面	正面
挺棒的感觉，环境也可以	正面	正面
很赞 好看的	正面	正面
好看搞笑，但是有点审美疲劳了	正面	正面
还不错啊 挺好笑的	正面	正面
看看就好，没有达到预期	正面	正面
很滑稽搞笑！	正面	正面
非常搞笑非常感人非常好看	正面	正面
挺好的，支持国产剧	正面	正面
最近看的不错的一部电影。全程全场都很欢乐	正面	正面
伤中带喜，喜中带伤	正面	正面
很好看，笑点泪点铺垫的都很好。	正面	正面
挺好，挺喜欢，幽默搞笑感人	正面	正面
堪比周星驰的功夫，沈腾、马丽的收官之作！	正面	正面
挺好的还可以	正面	正面
全程尬笑，剧情简单	负面	负面
画面不错，笑点不多，一般般吧	负面	正面
很好看，笑点多，特效很棒，要是3D就很好看了	正面	正面
搞笑是真搞笑，感人也是真感人，真心推荐	正面	正面
啊 啊的 哦	正面	正面
太好看了，我好久没有看见这么好看的电影了。	正面	正面
好，孩子看了不错	正面	正面
看着还行吧，陪对象一起看的，	正面	正面
独行月球 是谁笑着笑着就鼻子酸🍋了 宇宙这么大，我们还会遇见生活 或许总有遗憾，但未来依旧美好 推荐，今天是一个人去看的，还想下次再看一次	正面	正面
感觉不太好看！	负面	负面
腾哥演技炸裂，剧情中规中矩，有点类似火星救援	正面	正面
其实独孤说就是一个很平常的人物，他不愿意显摆自己，也有自己对生活和爱情的追求，在茫茫世界中，只剩下他和袋鼠的时候，她也会崩溃和绝望，想着去死，是袋鼠和地球上仅存的人类，给了他希望，是他对于自己喜欢的人的思念，给了他希望。最后，他抱着核弹冲向陨石的时候，直接的原因就是因为他想要守护自己喜欢的人，第二个原因就是想要回报这些给他希望的人类和袋鼠，最后一个原因，我想是他不再想回归到那种孤独到万物俱籁到境地了，死亡并不是绝境，孤独才是。	正面	正面
全局笑点不算很多，剧情有新意但还是有点老套	正面	正面
观赏挺好不错！	正面	正面
好看，搞笑得很	正面	正面
有情怀，有剧情，有演技，最重要的是有吸引力，这个夏天不可错过的好电影，支持沈腾，含腾量100%	正面	正面
没笑点，全程根本没笑过，比起以往沈腾的电影，不知道查多少，这一次，不推荐看	负面	负面
不怎么好笑，一般般	正面	负面
有笑点有泪点值得一看	正面	正面
难看 快要睡着了	负面	负面
别看，后悔一辈子	负面	负面
这个电影值得去看	正面	正面
有笑点有泪点 很不错	正面	正面
好剧情好演员！爱了爱了	正面	正面
如果独孤月可以活下来就好了	正面	正面
看到的评论特别多，都说好，除了特效、我觉得没意思，开心麻花这次电影虽然让我体验了一把视觉盛宴，其他觉得没意思😁	负面	负面
一般吧。可能是期待太大	负面	负面
不是3D，感觉这是沈腾马丽最不好笑的一部电影	负面	负面
还很不错，值得推荐，国产的喜剧电影中的俊俊	正面	正面
基本算是沈腾独角戏吧，其他人包括马丽都是配角，一个人撑了一部戏	正面	正面
太好看了，哭到不行，沈腾的那句带我回家彻底破防。这可是宇宙级的浪漫。	正面	正面
太好哭了呜呜呜 刚子也好可爱	正面	正面
你们觉得好看吗？从头到尾可能就花絮好看些 剧情老套到无以复加的地步	负面	负面
在暑期这个档期是能打的，喜剧自然是麻花最擅长，更何况沈叔叔表演的自然加分。特效水平在国内也可以说是相当不错了。但是整体的观感其实一般，一部及格的喜剧片吧，+1分给沈叔叔，6+1水平	正面	正面
中规中矩，还行吧	负面	正面
也就那样吧，情节单一  说是喜剧有不少尴尬的情节	负面	负面
你永远可以相信沈马组合！！！	正面	正面
很搞笑 哈哈哈哈哈😂 还是得我腾叔	正面	正面
可以好看好看	正面	正面
剧情画质演技剧情跌宕起伏画质感人演技炸裂 剧情好笑，画质一般，演技很好	正面	正面
画面震撼，特效也不错，刚子哥的特效最为逼真。喜剧效果很好👍狠有梗。 🌟 推荐  😊 演技  😂 笑点  🎉闪光点  🌅 画面  ✨观影贴士	正面	正面
非常好看，有笑有泪。	正面	正面
非常满意超级好看	正面	正面
非常非常好	正面	正面
好看得很 沈腾老师和马丽老师永远没让我失望过	正面	正面
刚子世界顶流	正面	正面
真的很好看，很感人。	正面	正面
帮助他人很快乐	正面	正面
比价好。。。	正面	正面
看起来是喜剧，但是却笑不出来，毕竟格局打开了，总的来说值得推荐观影！ 🌟 推荐	正面	正面
太好笑了，演技在线，含腾量超高，	正面	正面
一般，不是很好，但也能看	负面	正面
一分不能再多了	负面	负面
开心麻花延续一如既往地幽默、诙谐，大胆的想象空间给观众带来很多惊喜与感动！	正面	正面
搞笑感人！喜欢看他们的表演！	正面	正面
中规中矩吧，前一个半小时还不错，有看点有笑点，但后半个小时纯煽情，无法定义这个片子属于什么类型，全程围绕沈腾对马丽的一见钟情，总结就是一部带有科幻喜剧类型的爱情片。	负面	正面
悲喜交加，感人与快乐同在。好！好！好！	正面	正面
剧情非常搞笑，	正面	正面
超级棒，浪漫了	正面	正面
好看极了！ ，	正面	正面
还行，有点感动	正面	正面
好看，超级好看啊	正面	正面
有梗有料，推荐一看	正面	正面
就当是搞笑片看	负面	正面
很不错  适合带着孩子看看	正面	正面
还行还行沈腾有点惨	正面	正面
乐观的独处困境，灰谐的浪漫相思！珍惜且有缘！	正面	正面
太棒了  ！腾哥 丽姐的电影从未让人失望  一如既往的出色 ！！太赞了  ！	正面	正面
开心麻花没有烂剧	正面	正面
开心麻团队一如既往地好看	正面	正面
还好，剧情没有达到我的预期，总体来说是一部平平无奇的幽默喜剧	负面	正面
一般没啥笑点	负面	负面
很低档，拙劣的电影，也好意思宣传，纯为了赚钱啊，无聊极了。差评	负面	负面
一如既往的美味，分量也很足，已经推荐给身边的朋友们啦！	正面	正面
剧情一般，演技在线	正面	正面
不要错过这个	正面	正面
好看极了，笑点泪点并存。	正面	正面
剧情不错，演的不错	正面	正面
非常好看～最后一句话！ 马蓝星，带我回家！	正面	正面
不是我hey，确实个人觉得非常不好看	负面	负面
电影不错，就是电影院放映最后精彩的半小时一直断断续续，给电影院服务人员反应也没啥作用，而且观影者都在脱鞋把脚放在前面一排的座位上，很影响心情。下次不会去了。	正面	正面
可以冲！真的还可以	正面	正面
合格的商业片吧	正面	正面
幽默风趣之余，发人深醒。适合孩子观看。不轻易放弃，寻找希望。	正面	正面
可以说是非常好	正面	正面
什么也不为。为了沈腾。	正面	正面
沈腾的脸就是很好笑的了，再加上黄才伦简直了！很好看，黄子韬连形象都不要了，弄秃头，很佩服，很敬业！ 😂 笑点  😂 笑点  😂 笑点  😂 笑点	正面	正面
挺好看的、、	正面	正面
国产电影做到这样的效果，真的很不错了…而且很搞笑，非常推荐看看	正面	正面
好，很好，想二刷	正面	正面
今年最后一次陪女儿看了，还不错的！	正面	正面
笑死了嘎嘎好看，另外独孤月起飞那个片段太帅了	正面	正面
真G8ing异地磨牙	正面	负面
好看，而且很搞笑，是继夏洛特烦恼又一部搞笑的电影，沈腾马丽果然不负大众所望👍🏻👍🏻👍🏻	正面	正面
很搞笑 沈腾演的好	正面	正面
很搞笑，厅里坐了三分之二的人，经常哄堂大笑，看电影就喜欢看这种有喜剧效果的电影，希望过年的时候也能有这类的搞笑版电影，也不至于在家没事干，哈哈哈	正面	正面
自己去看.好看	正面	正面
电影很棒，旁边的小朋友乐的哈哈大笑	正面	正面
很感人的片子，意义非凡，引人深思。	正面	正面
总是会为了别人的感情感动	正面	正面
浪费时间生命浪费金钱	负面	负面
还可以  挺好的	正面	正面
烂片，毫无剧情，强行搞笑	负面	负面
好看的，搞笑也感人	正面	正面
很好，非常的喜欢	正面	正面
棒！又是沈腾马丽经典配方，爱死了！	正面	正面
好看又好吃，不腻，下次还会光顾的。	正面	正面
挺好的，情节挺好。	正面	正面
悲喜交加。有包袱搞笑，也有让人热泪盈眶的地方。很棒	正面	正面
真一般，没啥意思	负面	负面
陪孩子看看，喜剧人的电影关键就是看看图个乐…	正面	正面
超级好看 笑着笑着就哭了	正面	正面
剧情在线，画面很美，是个有笑点的喜剧片，但如果将自己带入主角的感情，又会有点伤感。总之是个很不错的电影，宇宙很美，但地球才是我们真正的家。但地球之所以对我们重要，是因为我们在地球上居住，地球上有这我们在乎的人。存在即合理，在美丽的宇宙之中，我们终究会相遇。	正面	正面
离我期待的差点	正面	正面
蛮好看，超级喜欢他俩	正面	正面
好看，搞笑，宇宙那么大，我们会再见	正面	正面
特别喜欢沈藤的表演！	正面	正面
还行吧。可以看	正面	正面
不错，沈腾自带笑点	正面	正面
剧情一般唉可惜了	正面	负面
一般般，反正能看	正面	正面
难得的国产搞笑大片，沈马组合真行，应该多出该组合的作品，非常好！	正面	正面
好看，比较搞笑的一部电影	正面	正面
挺搞笑的 刚子很可爱 感觉没有之前网上评价的那么不堪 看电影嘛 就图一乐呵 看的开心 就好了嘛	正面	正面
一般般 希望下次作品更优秀	正面	负面
推荐去看	正面	正面
沈腾马丽的电影一如既往，有笑点，有感动，开心麻花演员演技也一直在线，值得去看看 😊 演技🎉闪光点	正面	正面
很好看，开心麻花再一次刷新了我对它的认知。	正面	正面
不错，值得购买	正面	正面
很一般的电影，全程尴尬	负面	负面
当喜剧片还行，科技片一般。	正面	正面
非常好看，有泪点有笑点	正面	正面
挺好看的，真的挺值得看	正面	正面
还是很不错的，就是喜剧电影到最后为什么非得教育一下？	正面	正面
总体还是可以，很感人。	正面	正面
有笑有泪，在没有漫威的日子里，这部电影是最好的选择@	正面	正面
好哦！！！！	正面	正面
挺好玩滴'值得观看	正面	正面
好看的不得了	正面	正面
好看，前边搞笑，后边感动，值得一看	正面	正面
等级低放假呢打架就打架	正面	负面
不怎么样，感觉不是太好看，也不是太搞笑的，没有以前电影好看	正面	负面
不错，值得一看.	正面	正面
前面很搞笑 后面有点感人	正面	正面
不错，搞笑的同时也让人思考	正面	正面
嗯嗯，还可以吧	正面	正面
先笑后哭，笑得痛快，哭的也酣畅。	正面	正面
不好看，看的我都好无聊想走了，但无聊没地方去	负面	负面
太垃圾了，一直都比较喜欢开心麻花，想不到竟然拍出这样的片，无厘头，实在是无语😓	负面	负面
比预想的要好，本来我看到黄才伦的时候脑子都大了，当年李茶的姑妈着实给我了当头一棒，但是这部片子还蛮有意思，笑点也够，题材也新，礼拜五晚上看最合适啦，完全放松	正面	正面
整体说挺不错的，第一次对黄子韬有了好印象。以前一直不太喜欢小鲜肉啥的。黄子韬一口青岛话，真当时笑傻了	正面	正面
对不起科幻俩字 谈情说爱没劲	负面	负面
很好看 搞笑	正面	正面
挺好的，有不少笑点。	正面	正面
本来以为是一部合家欢喜剧，结果后半段哭得稀里哗啦，有一些明显的缺点，比如黄子韬突兀又尴尬，但不妨碍我的喜欢。 独孤月和马蓝星的爱情，一个默默暗恋快十年，一个在分开后才终于看到对方，故事的起点是马蓝星放弃独孤月按下了启动键，故事的终点依旧是马蓝星按下了最后的键，一切仿佛是求而不得的宿命，就像一念天堂里，男主最后还是在预设的结局里迎接了死亡。 画面效果很好，沈叔叔和袋鼠的演技很棒，牺牲和取舍都很勇敢，以及，人只要有希望就不会倒下。 虽然有的人觉得后半段比较无聊，但我觉得是极致的浪漫主义	正面	正面
剧情有点太搞笑 袋鼠最可爱 有魄力	正面	正面
剧情很好，大部分都独角戏情结也十分有趣，演员全员演技在线，喜剧中带着感动，笑和泪一起迸发，看了幕后也知道演员们的不容易，很精彩，期待更多麻花的电影 😊 演技	正面	正面
剧情说实话有点尬，有点强行煽情，虽说是喜剧科幻，但是月面是真空不能传声这种基本逻辑还是要遵守一下的吧	负面	负面
不好看 😭 哭点	负面	正面
非常好，很喜欢。	正面	正面
希望能多拍点这样的电影、一个字“棒”	正面	正面
很棒！～值得观影！～	正面	正面
好看的，有感动，有温馨，也充满着欢乐	正面	正面
不错挺好的电影	正面	正面
特别搞笑，哈哈哈哈	正面	正面
前面爆笑后面暴哭，泪点太低，还是希望能看个大团圆结局	正面	正面
还得是他俩演的好看	正面	正面
浪漫而且科幻，五星好评	正面	正面
袋鼠拉车配上A head full of dreams太绝	正面	正面
还不错吧嗯嗯	正面	正面
你真好看，长得好看的人怎么都好看(♥∀♥)	正面	正面
可以。不错的	正面	正面
还不错的很有笑点	正面	正面
挺不错的，娱乐性强	正面	正面
沈腾一个人撑起了一部电影，有搞笑点又有动情点，厉害了👍	正面	正面
放心来就对了，体验感一级棒，总之非常推荐各位来打卡	正面	正面
能让你泪流满面的有两种情况，一是大喜二是大悲；这两种情况同时出现的只有一个人能办到——沈腾！	正面	正面
开心麻花，沈腾的电影真的很不错	正面	正面
有泪点有笑点！真的很好看！不要看网上那些刷差评的真的很值得去看！！看到最后真的哭死了	正面	正面
推荐，感人的搞笑片。	正面	正面
肚饿uu诶饿就饿计算机额u金额就诶额	正面	正面
比预料的更好	正面	正面
还不错 挺解压的	正面	正面
很好看，很值得推荐	正面	正面
这个电影，很好看，挺感人的	正面	正面
很好看的片子	正面	正面
真心不怎么样！说是喜剧！没看出来！！	负面	负面
太好看了，无以言表，独孤月对马蓝心的爱刻在骨子里。世界那么大，保护你就是保护全世界。腾哥值得，一定要来支持这个电影！ 🌟 推荐  🎉闪光点  😊 演技	正面	正面
很好，沈腾演技硬。	正面	正面
很开心，搞笑	正面	正面
很好看，推荐大家去看！	正面	正面
很不错，棒极了	正面	正面
理论贴近科学的夸张喜剧，真实的看过想再看一遍。影片中的一些梗（包袱），就算是刷视频也不忍不住笑起来	正面	正面
非常好👍很搞笑	正面	正面
真的挺不错的	正面	正面
没意思 不咋地	负面	负面
每次最喜欢的就是点评电影阶段。好的电影和表演是能够带动观众情绪且让观众情绪随之变化的。开心麻花不仅仅有喜剧，在一定程度上推动了悲剧。我观影感受就是：独行月球中动物模拟“袋鼠”这么一个夸张的角色，即是动物却有着人的各种形态与感情可以看出导演的用心 并且无形中强调“人与动物都是相等的”一起经历风雨一起共患难生死。镜头中即搞笑又悲伤把喜剧完完全全的展现给观众 最后的彩蛋也是令我比较惊喜的 让我觉得结尾是开放的结局 你愿意相信他是好的结果 那就是 但是往往这么一个喜感的人物才最具有悲剧代表性。看了这个电影满足了我各种天马行空的想法 那就不管结局怎么样去实现自己想要的吧 🌟 推荐  🌟 推荐  😂 笑点  😭 哭点	正面	正面
独行月球，恰到好处！	正面	正面
回家之路，hotel China	负面	正面
笑点满满，值得一看	正面	正面
不好看 笑点不够 容易困 故事单一 角色塑造丰富性不够	负面	负面
好看吖好看吖	正面	正面
当成纯喜剧来看看就很好  感觉没必要后期突然升华	正面	正面
很好看，搞笑，哈哈哈哈	正面	正面
好看，每当有一部国产科幻，就有上海堡垒被网暴，是真的好看。结尾也很棒做的。	正面	正面
很好看，最后有点遗憾，不过也很好，剧情也很喜欢，对我来说很搞笑也很感动，感性的我留下了许多泪水。	正面	正面
真的好看 挺感动的 为了一个人和一群人，牺牲自己， 你是好样的	正面	正面
还是可以看看的，	正面	正面
剧情很好，演技很好	正面	正面
不太好看一般般	负面	负面
剧情一般，升腾演技在线。	负面	正面
值得推荐的喜剧（？）科幻片。 但是喜剧不是全喜剧。科幻多少缺点硬核。作为普通人会很喜欢。可能会被科幻迷挑刺。 前面的喜剧和科幻没有结合好，会稍显剧情松散，但是后面和情感。自我牺牲，升华了剧情。 老实说前面笑的时间比较少，但是后面哭的时间很多。主角救刚子，激励着地球的难民，坚信能回家，发挥聪明才智造回家的火箭，最终化作了绕地的陨石带。 对于喜欢爆米花喜剧的朋友可能有些不友好，因为主角最终没有活下来。他一直是“独孤”，最后在地球人的注视中选择了牺牲自己。意难平，却没有迎合大团圆。  奇迹可能不会发生，但人类永远伟大	正面	正面
画面可以蛮漂亮的，比较搞笑	正面	正面
第一次看了出男主角壮烈牺牲了的电影，袋鼠的特效好赞，支持国产电影	正面	正面
不是完全的喜剧，还有一部分正能量的力量感染我们，让我们对生活充满希望，很值得看的一部电影	正面	正面
制作在预算范围内合理，主要靠演员发挥，作为商业片是合格的了	正面	正面
挺好看的 喜欢沈腾	正面	正面
还行 蛮好看的	正面	正面
电影很好   只是个人心情不好	正面	正面
挺好的，我觉得很感动	正面	正面
好看，值得！	正面	正面
还行吧，下次再来看	正面	正面
科创加喜剧，剧情最后有升华，很大爱，很好看！	正面	正面
结局有点惨，剧情不太清楚	负面	正面
这是科幻爱情片吧，但不能考虑逻辑，爱情的部分好突兀，刻意煽情的片段也太多了	负面	正面
棒极了。拍的很用心，2022年值得看	正面	正面
太好看了 推荐推荐	正面	正面
不错   好看  值得	正面	正面
前段笑死人，后段让人留累	正面	正面
很有艺术气氛，启蒙孩子对太空的向往，人文气息浓厚。充分抒发中国独有大家小爱的的精神，幽默搞笑的特点推动着电影的发展，优美的音乐结合异想天开的太空旅行打破了宇宙冰冷死寂，结尾强烈的精神输出将气氛推动又一个高潮，老少皆宜	正面	正面
还可以，哈哈哈	正面	正面
一般，刚子不错	正面	正面
笑点可以。总体不错	正面	正面
总体还不错，前期笑哈哈，刚子太出彩了。给好评	正面	正面
剧情不错，演的也很好，我面无表情地看完电影	正面	正面
打卡独行月球，是谁笑着笑着就鼻子酸了，宇宙这么大我们还是会遇见，你是真冷血，我是真喜欢。生活或许总有遗憾，但未来依旧美好 ！！！	正面	正面
我觉得很好看，看到腾哥就想笑 但是也很感人 挺喜欢的	正面	正面
蛮好看的呵呵	正面	正面
不知怎么说很差的电影	负面	负面
沈腾马丽演技在线，特效画面也不错，可能因为影院人太乱，没啥沉浸体验感，一部想来二刷的电影，沈叔叔50亿冲起！！！	正面	正面
笑中带泪，非常般配	正面	正面
特别好看。棒棒哒！	正面	正面
还好吧，中规中矩的一部影片，爆米花味道，能接受！	正面	正面
没啥可说的。	负面	负面
好看还行比较搞笑	正面	正面
好看  感人	正面	正面
真的很好看，虽然是喜剧，但是很有深度，最后哭的老惨了，超级推荐！	正面	正面
舍小家为大家，感动了	正面	正面
不知道怎么样，帮别人买的	正面	正面
还行吧，笑点挺多	正面	正面
马兰星！带我回家！	正面	正面
没意思，完全爆米花🍿️	负面	负面
凑合吧还行。	正面	正面
一开始有点无厘头，后面又搞笑又感动	正面	正面
剧情不错，有欢乐也有感动，适合一家老少观看，好沈腾马丽的电影从来不会让观众失望的	正面	正面
挺好看的，可以尝试	正面	正面
沈腾的演技太绝了，他带给我们的笑点和泪点真的是让观众们一步不落的跟随，可以说笑着哭哭着笑，但是到最后我们还是会能深深地明白，在地球面前，我们人类真的很渺小。虽然片段中有不切实际的情况，但并不影响整个剧的搞笑。	正面	正面
休闲娱乐的电影 挺逗的	正面	正面
好看，搞笑，值得一看	正面	正面
剧情一般演技一流总体一般	负面	负面
好看好看，值得推荐	正面	正面
很不错，推荐	正面	正面
虽然生前平凡，但死后很璀璨	正面	正面
好非常好 🌟 推荐  🌟 推荐	正面	正面
挺好的，沈腾马丽组合。	正面	正面
个人主义与英雄主义的完美调和，中国式幽默与话剧式情感的巧妙融合。	正面	正面
前一个小时蛮搞笑的，后面剧情比较煽情。	正面	正面
记住永远相信沈马组合	正面	正面
真的很喜欢！	正面	正面
刚开始挺搞笑的，中间就不搞笑了，后来就后来了。	正面	正面
不用说了，都给我看	正面	正面
剧情一般，看了开头就知道后续发展的剧情，笑点有点低俗尴尬，导演画面拍的可以，特效也可以，总体就是可以看看	正面	正面
今年到目前为止最好看的电影	正面	正面
不好看，失望	负面	负面
真的还不错啊！不能说是个什么精彩绝伦的大片，但是从演技 画面 效果 布景 多个角度来看，绝对算得上是质量比较高的电影，而且笑点不尬，电影院里都是开怀大笑的声音，也有几个地方是笑中带泪，结尾会有些强行煽情，但是也觉得结尾情节安排合理，只不过煽情强度略大。 本来就是图一乐呵的电影，不知道为啥网上尤其微博尬黑的人那么多，是疫情当下真的内心拧巴还是要求标准太高还是有人故意指引风向。	正面	正面
笑点泪点爱情科幻未来这些元素都有了	正面	正面
很不错，有沈腾的电影一直都很好	正面	正面
非常搞笑！开心麻花又一搞笑作品！	正面	正面
非常的奈斯！	正面	正面
好看非常有意思	正面	正面
好看，值得一看。	正面	正面
很好看，强烈推荐，但是里面物理的，有点问题，不过还好	正面	正面
超好看的，有泪点也有笑点，真的永远相信开心麻花，永远相信沈腾，永远相信沈马组合	正面	正面
搞笑不足，价值太高有点奇怪。	正面	负面
很好看呀，挺不错的	正面	正面
好看 好笑	正面	正面
剧本一般 演员演技挺好	正面	正面
剧情基本能猜到出来了，特效9分，演技满分，不过还有点小细节漏洞	正面	正面
不错，很好吃，量很足，味道很好，经常点。	正面	正面
还挺好看的，有欢乐有感动	正面	正面
演员演技真的很不错，太棒了，很喜欢这个片子，真的是边哭边笑	正面	正面
非常好看额	正面	正面
挺好看挺好的	正面	正面
还行吧，但是有点希望有点高了	正面	正面
结局有点意难平 很好看	正面	正面
不是很满意，没有期待的那么好	正面	负面
“沈马”组合超好，含腾量100%的麻花电影、值得推荐	正面	正面
剧情蛮好的，没有差评写的那样子啊，还害我担心了是不是不好看~ 前期是蛮搞笑的，最后半小时左右才开始有点严肃起来。 给电影赞一个	正面	正面
就一般般，没有很惊艳	负面	负面
好吧一只眼睛	正面	正面
前半段很欢乐很搞笑，太空特效很精致真实，原来喜剧也能和软科幻结合的这么好。沈腾拉着金刚鼠在月球上飞奔，陪着Coldplay的音乐，无比应景！后半段又把沈腾塑造成一个大英雄，这是很出乎意料的。沈腾真是被低估的演员，在眼神和微表情上是有着一定演技的。泪点和笑点齐飞，这一定会成为暑假的大爆款！	正面	正面
好看，搞笑，走走伤感	正面	正面
还行吧，中规中矩的喜剧片	正面	正面
钱后半段都行	正面	正面
烂片一个，开心麻花最差劲一部，一点笑点都没有，跟夏洛特烦恼、西红柿首富差十万八千里！	负面	负面
特别好看，画质清晰流畅	正面	正面
很不错😊😊	正面	正面
目染眉的人真的可以接受	正面	正面
很赞 加油	正面	正面
哈哈哈哈还差差	正面	负面
剧情搞笑又感动，画面感真实，冲击力很强!	正面	正面
沈腾演技在线，感动也不失幽默	正面	正面
挺好值得推荐	正面	正面
麻花必出精品👍🏻	正面	正面
好，边哭边笑	正面	正面
good棒极了	正面	正面
这部电影毫无槽点啊，虽然说主角的运气可能是背了点，但是剧情，特效，演技等各方面完全都是满分的呀，值得推荐，非常推荐，适合一个人去看啊	正面	正面
有笑点，有泪点，可以	正面	正面
独行月球超好看的，腾哥智商超在线，超级喜欢沈腾和马丽这对神仙搭档！演技很高超，电影很好看❤️❤️就是最后独孤月的那句“马蓝星 带我回家”很意难平。独行月球票房大卖👍👍#沈腾马丽神仙搭档	正面	正面
沈腾的喜剧电影真是赞	正面	正面
「独行月球」才是开心麻花电影该有的样子。这次的开心麻花，绝对能让喜欢他们作品的观众，心满意足的走出影院。	正面	正面
这不比那个什么堡垒强？	正面	正面
很不错的哦。	正面	正面
最打脸的就是，月盾计划是中国提出来得，后又失败了	正面	负面
挺好看的还不错可以去看看	正面	正面
很适合带着孩子一家人看的电影，小朋友当科幻片看看火箭🚀宇航员袋鼠可以看得很开心，大人当超长小品喜剧电影来看也能笑得很开心。真的蛮不错的	正面	正面
真的很好看啊～	正面	正面
不错，含腾量十足，泪点也十足。感觉有笑中带哭呢	正面	正面
超级搞笑，泪点恰到好处.	正面	正面
挺好的，七夕那天去看的	正面	正面
非常好看，现在是什么	正面	正面
可能赶了个最晚场，不错	正面	正面
好看！有笑料，有感动！	正面	正面
直接满分含腾量拉满 笑个不停	正面	正面
太难看了，要好难看有好难看！喜剧不像喜剧，科幻不像科幻！剧情粗制滥造，结局又是那种典型牺牲主角，拯救全世界的爱国主义情怀！我觉得这个编剧可能确实是个傻X！去看这部电影完全是浪费时间和金钱！网上票房绝对做假！这是我近年来看过最烂的一部电影，没有之一！	负面	负面
剧情一般 画面不错 结局勉强	负面	正面
看过了觉得喷子为了喷而喷，剧情、特效都很好，让我们感觉到人类在宇宙中是多么的渺小，呼吁大家关爱地球，同时也有很多笑点，看电影看自己带着什么样心情看的吧，不一样的心情看出不一样的感受，反正我看完还意犹未尽，你可以永远相信沈叔叔	正面	正面
沈马组合的演技还是在线的，月球，金刚鼠的特效也不错，虽然不是真正的科幻片，值得一看	正面	正面
喜欢开心麻花的阵容	正面	正面
好好看，笑点很高，记得带水进去，不然像我们一样笑到好口渴😁	正面	正面
搞笑，感动，震撼，带有一点点科普知识，带娃看的，把娃感动哭了，推荐观看	正面	正面
还行吧，孩子爱看就行	正面	正面
不错挺好 挺搞笑	正面	正面
我怎么感觉好一般😂	正面	负面
垃圾 啊啊啊啊啊	负面	负面
好看，特别搞笑	正面	正面
题材很新颖，很有创意，看这个就感觉国家很强大，科技的重要性。 笑点泪点都很多，剧情紧凑，好多喜欢的演员，含腾量超高，还有黄子韬参演，好多熟悉的小演员，演技都很好。 最后结局也算圆满，虽然男主角死了，但是最后的出场特别好，星空下没有影子，总觉得后面有彩蛋，等到影城都播完黑屏才走的。	正面	正面
还可以吧也就	正面	正面
很好，值得大家去看	正面	正面
很一般、笑点很尬、完全是冲着沈腾马丽去的、但是很失望！	负面	负面
前面笑的有多狠，后面哭的就有多惨。	正面	正面
冲着沈腾马丽去的!真的好看!	正面	正面
开心麻花的电影居然以悲剧结尾，有点不适应	正面	正面
好看 推荐一下	正面	正面
好 好好好咳咳	正面	正面
木有剧情，其他还好	负面	正面
剧情老套，情节牵强，浮夸，广告植入多，强加笑点，不好看，超级不好看	负面	负面
真的好搞笑😂	正面	正面
9.5分是值得拥有的，轻松愉快，没有太浮夸，没有太煽情，开心麻花中等偏上的水平	正面	正面
演技很好，丽姐在这部电影的造型参加漂亮	正面	正面
特别好，非常不错	负面	正面
非常好看，笑点密集，值得一看	正面	正面
特别好看 不错	正面	正面
太有意思了，乐的我大鼻涕泡都出来了！	正面	正面
还可以吧，有点闹	正面	正面
好看 但是不要认真	正面	正面
对我来说就那样不太好看	正面	负面
不是很好看，剧情一般般，偶尔有几个笑点	负面	负面
挺好看的，有搞笑的有感人的，就是又笑又哭	正面	正面
剧情新颖好看！	正面	正面
很好看，也特别的搞笑	正面	正面
看迷茫了……喜剧片？言情？科幻？灾难？！3分给开心麻花	负面	负面
沈腾加马丽绝	正面	正面
都还行，可以去看看	正面	正面
环境舒适，画质也不错	正面	正面
很喜欢沈腾马丽的电影	正面	正面
果然 喜剧的内核是悲剧  很不错 沈腾的影响又高大了很多	正面	正面
还行吧，不错不错	正面	正面
好看！！被黄子韬笑死哈哈哈哈哈	正面	正面
电影好看 环境可以	正面	正面
很不错，很搞笑，适合几个人一起	正面	正面
very Nice!	正面	正面
很好很好好棒	正面	正面
感动，有趣，插曲和结尾的音乐都很好听	正面	正面
非常搞笑，强烈推荐	正面	正面
搞笑、科幻片有点像样了，沈腾演技在线，这年头拍喜剧不容易，能逗笑观众更难，要求不要太高，什么科幻逻辑性不强，剧情老套等，这些重要吗？我们只要能在这2小时内，看着好笑解压就行了，三年疫情大家都挺不容易的，你还想要什么内涵？什么又红又专？什么科幻逻辑？对国产搞笑科幻片宽容点吧。总比韩寒拍的垃圾的四海要强的多吧？话说沈腾千万别再拍韩寒的垃圾片了，自己拍拍挺好的。	正面	正面
烂片 水军多 开心麻花 你口碑完了	负面	负面
非常不错 好看	正面	正面
好看是真好看，结局意难平啊	正面	正面
挺好的，有搞笑部分，也有煽情部分	正面	正面
好评，鼻涕流满了整个口罩	正面	正面
好看，神马加油	正面	正面
喜剧之王，沈腾称得上这个称号！总是给大家带来欢乐，虽然剧情很老套！	正面	正面
我的感受   敬畏自然   善待地球    还有就是向航天前辈致敬   宇宙只有寂静	正面	正面
暴躁的刚子啊	正面	正面
打一百分 超级喜欢马丽和沈腾 终于他们又在一起合作了 开头和中间真的很搞笑 我已经看了两遍了 最后还是比较触动我的 推荐推荐 希望马丽和沈腾的演员道路越来越好！	正面	正面
喜中带悲，悲中带喜，有些笑点包袱感觉有点硬，有些人物剪辑不连续多余，夏洛特烦恼还是开心麻花的天花板，总体还是不错	正面	正面
班级聚餐聚会都在吃哦！	正面	正面
好看，可以一试	正面	正面
很好看，也很励志，主要就是想看沈腾和马丽，他们的表演很精彩	正面	正面
🌌即使星河千里，也会用尽全身力气  遇见你 🌌“我们终会相见”	正面	正面
当代卓别林，国产周星驰，喜剧日渐衰微的时代，只有沈腾能扛起旗帜，没有一个人能够代替他的存在，也许他的电影不够高级，也许他作品没有深度，阳春白雪注定曲高和寡，下里巴人才是王道。	正面	正面
不錯，很大气，很壮观👍	负面	正面
不要带脑子看这个电影 单纯的当个喜剧片还勉强可以看 只限前半截搞笑 很尬的那种 别信这个评分 假的假的	负面	负面
真的超级满意	正面	正面
影片搞笑氛围浓厚，能看出导演细致的点睛之笔，前后呼应出了“中间人”，让人在欢笑的同时感动满满！	正面	正面
挺搞笑的，还不错哦	正面	正面
一个字，牛🐮 ，最爱沈腾	正面	正面
电影还不错，看着挺好的。	正面	正面
好看啊 又好笑又好哭	正面	正面
好看！好看又感人	正面	正面
很好看，特别好看	正面	正面
挺好，可以，不错	正面	正面
还行，没有想象中的好玩	正面	正面
感觉没有前几部沈腾主演的电影好看。	正面	正面
中规中矩吧 ！	正面	正面
好看，搞笑很	正面	正面
画面和演技没的说，但是剧情还有待提升	正面	正面
整体不错吧，还行吧	正面	正面
剧情还不错，开心麻花出的电影永远都不会让人失望！	正面	正面
没看上还退不了可咋整	正面	负面
剧情可以，画面完美	正面	正面
太好看啦 腾哥丽姐yyds！	正面	正面
工作人员服务态度很好，客气也有礼貌，挑不出毛病，来打五星。	正面	正面
沈马组合 yyds！	正面	正面
挺好的 特别棒	正面	正面
有欢笑有泪水	正面	正面
新的中国科幻巅峰	正面	正面
眼泪在眼眶里	正面	正面
情节感人，值得一看	正面	正面
一般，不是太好看	负面	负面
好看。值得推荐	正面	正面
挺好的呀！！！！	正面	正面
独孤月最后用他的坚持感动了马蓝星，很好	正面	正面
非常搞笑的一部喜剧片	正面	正面
我哭了搞笑又好哭	正面	正面
方方面面都很好	正面	正面
很好看，也很感人。	正面	正面
好看！非常励志！	正面	正面
蛮好看的不给满分怕骄傲	正面	正面
前面在笑，后面又感动到流泪，很喜欢这部电影，把喜剧和科幻大片融为一体，既有趣又振奋人心	正面	正面
挺好看的，沈腾演技在线	正面	正面
沈腾最后的一跃，和钢铁侠一样帅	正面	正面
真的好看值得推荐	正面	正面
很好，非常好看！	正面	正面
特别好，不愧是百亿票房的得主	正面	正面
很有趣的一部电影	正面	正面
上周已经二刷了，明天准备三刷，总惦记看	正面	正面
开心麻花的喜剧让我想一直刷，希望以后可以继续有好电影	正面	正面
满分电影 虽然个别剧情中情绪转换不是特别顺畅 但是也能够看出沈腾在努力的转变作品风格 电影结局更是突破常规让人眼前一亮回味无穷 除了袋鼠出现前期有些尴尬以外 没啥别的毛病	正面	正面
一如既往的好沈腾马丽最佳搭档！	正面	正面
剧情可以，画面不错	正面	正面
好看！！！特喜欢刚子	正面	正面
尬笑吧，一般般，刚子比较好	正面	负面
如果是对于科幻片有需求的朋友，就不要去看了，以免有些人西瓜里挑芝麻，这部片子真的非常非常好	正面	正面
全程都认真看了，沈腾演技很棒	正面	正面
圈钱之作，没啥好说的	负面	负面
蛮感动，不错	正面	正面
感动搞笑的好电影，孩子喜欢看	正面	正面
我愿永远做你的星环，默默守护你的璀璨。	正面	正面
救命！爷青回！！终于等到沈马再次合作了 演技还是没得说  真的很好笑~ 😊 演技 他们俩在一块真的没救了 我有看到了几年前的丽姐 合作真的还是很棒的 然后剧情也很好 那个金刚鼠也做的很真实！里面演员的演技真的很棒！现场观众的笑声就能看出来 也有很多地方让人感动！只可惜有事最后十几分钟没看到	正面	正面
质量不错值得推荐	正面	正面
带着孩子看的，总体来说，值得一看，笑过，也感动过………………	正面	正面
总体来说配不上9.6的评分，最多8.5。	正面	负面
很棒，还是一如既往的好，沈腾不亏是沈腾	正面	正面
太有包袱了！	正面	正面
不错也搞笑有深度	正面	正面
前半段搞笑  后半段感人	正面	正面
剧情很棒，很好看	正面	正面
票价值了，值得观看	正面	正面
今年看的电影里面最次的一部 不知道为什么会有9.3的评分	负面	负面
挺好看的，特效也不错	正面	正面
笑中带泪，从个人角度上升到人类角度，沈叔叔真的很棒！沈马组合冲！！！	正面	正面
这部电影简直太棒了可以直接冲 沈腾和马丽的表演是真的好 一个场景演出多种感觉	正面	正面
超好看[流泪][流泪][流泪]快去冲，我都觉得可以成为电影的里程碑！[流泪]	正面	正面
挺感人的，沈腾还是一如既往的优秀！	正面	正面
非常好看哈哈哈哈哈哈	正面	正面
好看 精彩刺激	正面	正面
喜欢好看好看	正面	正面
很好笑 特别腾哥的各种搞笑风格	正面	正面
好看，喜欢！	正面	正面
好看，沈腾叔叔必出经典	正面	正面
挺好看的 你可以永远相信沈腾	正面	正面
还不错，挺好啊	正面	正面
搞笑的搞笑感动的感动恰到好处	正面	正面
环境很好，因为人来很多，就更有氛围了，不错下次还来！	正面	正面
之前就有强烈预感要翻车，果然，看预告片就把所有笑点看完了…水军真多	负面	负面
哟哟哟切克闹	正面	正面
全程都有笑点，老戏骨演技精湛	正面	正面
有一个地方差点哭了下一秒直接被整笑了	正面	正面
加油中国科幻片！	正面	正面
搞笑，好看推荐推荐	正面	正面
电影好看搞笑	正面	正面
很好看，搞笑又感动，没有过度上升和煽情，特效也好！今年的好电影，推荐！	正面	正面
剧情如果在慢一点会更好，很不错的电影，媳妇依偎在我怀里许久	正面	正面
很好看，推荐！	正面	正面
剧情很类似《火星救援》，特效画面算很用心了，笑点一般，观影前没看介绍和评论，看到开心麻花就觉得是部喜剧片。9点多的分数感觉偏高了，但整体还可以。	正面	正面
适合两个人休闲时看的电影，不费脑有笑点，宇宙这么大，我们却相遇	正面	正面
好看，还得是沈叔叔	正面	正面
还行～～～～	负面	正面
有点无聊。。。。	负面	负面
😂 笑点多 结尾感人	正面	正面
我曷一娥人人	正面	正面
太好了！！！！	正面	正面
开什么玩笑，看这部电影就是奔着好笑去的，讲逻辑我就去看刑侦剧了。 你想好笑，这片子让你好笑。不做对比，就本片而言 好笑。	正面	正面
笑死的路上，很好看！	正面	正面
剧情很好看，又搞笑！	正面	正面
垃圾烂片????	负面	负面
体面挺好不错，期待更好的电影	正面	正面
后面有点煽情	正面	正面
很不错，有笑点，有泪点 另外如果你非要揪着一些科学原理不放的话，那你真的太没趣了，就好像你看春晚小品是为了被教育一样。	正面	正面
很搞笑的电影，但是结局be了	正面	正面
这40块不值得	负面	负面
为什么不给退款	负面	负面
唔好睇，完全系低级笑话，又唔好笑	负面	负面
超喜欢金刚袋鼠，很生动的表现力，最后还幸存了下来，很幸运啊。	正面	正面
好看，永远相信腾哥	正面	正面
非常的好看！	正面	正面
中规中矩，，	正面	正面
软科幻，但是剧情挺好。作为喜剧片这个科幻程度很不错了。	正面	正面
只能说很中规中矩，没有什么突出的地方，能看，但是有点想玩手机。	负面	正面
好的很，有乐有悲	负面	正面
有笑点，画面好看	正面	正面
这是什么玩意？	负面	负面
还行不错一般般嗯	正面	正面
挺不错的，哈哈哈哈	正面	正面
笑点有点尬。	负面	负面
可以，推荐啊	正面	正面
剧情好棒，很搞笑	正面	正面
很好看很搞笑，很浮夸	正面	正面
连刷2遍，“马蓝星，带我回家”直接破防	正面	正面
很喜欢，挺搞笑的！	正面	正面
信念，没有末日。	正面	正面
除了个别梗挺好笑，后面的上价值有些猝不及防和突兀，强拗的感觉，是沈腾所有的电影里我觉得最不好看的一部	正面	负面
个人特别喜欢这部电影的设定和寓意！我腾的演技自然不用多说，那叫一个绝！虽然包袱创意没有过多的翻新，但是用得还是挺舒服的！能够让我去到影院支持的星级演员真不多，就腾哥和星爷。所以，希望大家去到影院看这部电影的时候，更多的是带着轻松享受去的，而不是带着键盘在敲。	正面	正面
真的超级好看，演技在线，最后的结尾我真的会哭	正面	正面
除了尴尬还是各种尴尬…过时了的网络段子…无语	负面	负面
还行，笑点很足	正面	正面
还可以，有搞笑的也有感人的😁	正面	正面
还不错，又搞笑又感人的，但我期望太高，所以有一点点的失望，不过相对来说，还是挺不错的了	正面	正面
好看，好看，非常好看，准备二刷！	正面	正面
不错不错，推荐推荐	正面	正面
不行 这个剧情没意思  宣传片挺好  去看了是真不行	负面	负面
一般，剧情不太好	负面	负面
嗯，去看的时候还被评论里的两极分化给带歪了，说什么不好看，但是我和妈妈去看的是真的好看，本来我妈本人不是沈腾的粉丝，但是看了之后就会觉得很好看，真的很好看，要去看呀，前面就很喜剧，后面就很感动，，，，剧情紧凑，而且真的很好看，没有一个地方是多余的	正面	正面
情节很紧凑，没有什么废话。腾哥折服这么长时间终于憋了个大的！赞👍	正面	正面
一般123456	负面	正面
冲着沈腾来的，看完只能说还行，做为喜剧片来说不够喜剧，话剧舞台剧音乐剧的合成	正面	正面
经典电影，值得推荐！	正面	正面
沈腾叔叔yyds！含腾量极高！	正面	正面
很好看！很不错	正面	正面
震撼，感人，搞笑	正面	正面
不错不错可以	正面	正面
还不错 刚开始一般 后面好看	正面	正面
又哭又笑 不愧是含腾量100％的电影	正面	正面
比较开心，搞笑，幽默，有趣！	正面	正面
特别好	正面	正面
勉强可以一看	正面	正面
含腾量很高，很好的一部喜剧片，宇宙级的浪漫，又搞笑，又浪漫，又感人。	正面	正面
不错电影挺好看	正面	正面
全程都在笑点上，最后来个小煽情，结局是还是圆满的	正面	正面
这个评分怎么来的？	负面	负面
满分！！！！	正面	正面
可以 挺好看的	正面	正面
美团扣分，谐音梗扣分！	正面	负面
搞笑，灯光几个字太有脑洞了	正面	正面
欣赏不来，不好看，我儿子觉得好看就行	负面	负面
好看 真的好看	正面	正面
剧情挺好的，挺好看的	正面	正面
开心麻花剧 很Nice	正面	正面
沈腾马丽yyds！！开心麻花yyds！	正面	正面
体力好吗……不会	正面	负面
好看 很感动人	正面	正面
后续声音挺大的，感觉有点吵，内容看着很好	负面	正面
前期欢乐后期悲	正面	正面
一般没有期待的好看	负面	负面
不错，喜欢沈腾	正面	正面
好看。含腾量极高，喜剧效果拉满，感动的地方也很多，非常成功的商业喜剧片，没让我失望 🌟 推荐	正面	正面
🌟 推荐 欢笑的同时也有悲伤，开心麻花很多次都是这样。   😊 演技 小女孩哭的时候直接🔪我心里了，我也跟着哭了，沈马联合还是不错的。   🌅 画面 画质真得很不错，应该是大制作。	正面	正面
挺好的 就是后面独孤月没回来有点可惜	正面	正面
喜剧片非要悲剧结尾，所有的情节全部可以预料，只能说开心麻花也给人种江郎才尽的感觉，情节手法都开始混不吝了	负面	正面
真的是一部很有意思的电影	正面	正面
剧情还可以，人很少，	正面	正面
很棒很好满足了	正面	正面
一般般 不怎么好看	负面	负面
破剧情，破特效	负面	负面
很好看也很搞笑😁	正面	正面
感人 搞笑🤪好评	正面	正面
麻花出品，每次必看	正面	正面
好看好看好看！极力推荐！	正面	正面
不一样的星球灾难喜剧篇，可以一视👻	正面	正面
📍第一次来，幸好有工作人员的耐心讲解，收获非常美好的回忆	正面	正面
nice，场景和配乐很搭，演员演技在线	正面	正面
特别搞笑，开心麻花绝了👍	正面	正面
真的有好笑又好哭超好看	正面	正面
还可以，第一次看到中国的月球电影，袋鼠很赞	正面	正面
挺不错的 沈腾自带喜感	正面	正面
好看好看，一定要去看	正面	正面
剧情连贯，笑点暴多，最后还能贯穿整个剧情！全程每一分钟都不容错过！ 画质可以，和流浪地球一个级别！	正面	正面
不搞笑，一般	负面	负面
🌟 推荐 有笑有泪有故事有创意  😭 哭点 全民齐心做一件事情时候的感动和后面不得已选择牺牲的难过，说好的喜剧呢，最后的be来得猝不及防。	正面	正面
很好看   也很搞笑	正面	正面
好好 hao	正面	正面
一般般。。。。	负面	负面
还行 挺好看	正面	正面
很好，沈马组合yyds	正面	正面
还可以 当个喜剧片看 不要太深究	正面	正面
一般般吧一般般	负面	负面
开篇挺好笑的，中途有些小感动也挺好。专心搞笑其实挺好的，大团圆结局也不是不高级。不用非得最后来个催泪弹，我花钱看就是为了高兴的。	负面	正面
感动并搞笑着	正面	正面
还不错，中上水平	正面	正面
太好看了，笑着笑着就哭了	正面	正面
还好吧，可能对沈叔叔期望太高了，电影院热的发懵，汗流满面，呼吸困难	负面	正面
一般吧 不喜欢	负面	负面
个人英雄主义拯救地球，感觉剧情有点熟悉？	正面	正面
还不错，科幻喜剧片，新梗也不错。	正面	正面
强行催泪，我不理解	正面	正面
真的很好看啊	正面	正面
演技在线，笑料很高级，特效很震撼，背景音乐很到位，笑中有泪 ，不得不👍。最爱钢哥！	正面	正面
一般，超级一般，	负面	负面
非常好不错的	正面	正面
有第二部吗？	正面	正面
好极了！！前边笑死，后边哭死	正面	正面
这部电影很值得观看，后面的彩蛋为了弥补心情，独行月与马蓝星在月盾基地重遇😭你永远可以相信沈马！ ​	正面	正面
又搞笑又催泪又浪漫的一部电影，看了绝对不亏，冲99%的含腾量我直接拉满。	正面	正面
看一看，乐一乐。	正面	正面
值得一看 顶流刚子	正面	正面
好看。	正面	正面
好看呀我就喜欢沈腾	正面	正面
有笑点 有泪点 挺好看的	正面	正面
挺好的故事，不需要推敲细节。隔壁的小女生，笑起来前仰后碟尖叫不已，哭起来也是耸肩拭泪几乎**，真是挺受欢迎的	正面	正面
每次看沈腾的电影都是笑的过，结局很感动	正面	正面
很好看…………	正面	正面
非常好很感人	正面	正面
挺好看，支持	正面	正面
不错😊非常喜欢	正面	正面
笑到肚子疼。	正面	正面
带女儿看的，她很喜欢。	正面	正面
哈哈哈哈几把	正面	正面
很开心哦，推荐！	正面	正面
挺好看的加油	正面	正面
哈，可以😌	正面	正面
可以。全程都有笑点	正面	正面
真心不错 不要总听一些人嘴上说的 去现场看一下就知道了 一切值得	正面	正面
马蓝星，带我回家😭😭😭	正面	正面
很赞很赞简直了哈哈哈😂😂😂😂	正面	正面
个人感觉很一般，特别反感辣目洋子，搞不懂为啥要她处境。沈腾和玛丽可以弄点儿好看的、质量高点儿的喜剧。个人观点，不喜勿喷！	负面	负面
剧情很精彩 推荐	正面	正面
好久没看电影了，很不错	正面	正面
很好看，爆笑，有意思，喜欢看喜剧的不要错过	正面	正面
可以，比较搞笑，情节经不起推敲。	正面	正面
还行，马马虎虎	正面	正面
我觉得挺好看的啊	正面	正面
这回八番很帅	正面	正面
感觉不咋好看，奔着沈腾和马丽去的，看完挺失望的。剧情很俗气，看的人想睡觉，搞笑只有前面一点，后面就强行煽情，而且煽情的点还很低级和幼稚，像是给小孩子看的那种，可以说是沈腾马丽最差的一部影片了。	负面	负面
搞笑 ，是我喜欢的	正面	正面
挺好的 蛮不错	正面	正面
猫眼43抖音35，而且还有其他优惠！没什么营养和意义，很普通的片子，感觉不值！	负面	负面
让你懂得好好珍惜你的男人	正面	正面
不是好看太差了	负面	负面
nice！非常不错了	正面	正面
来了这么多次没有踩过雷，非常不错，想来的可以冲了	正面	正面
很好看的哦   沈总演技派明星	正面	正面
感觉一般，没有那么搞笑	正面	负面
末日外太空专灭百亿票房先生，前有吴京今有沈腾，太残暴了~说实话，改的完全失去了原作漫画的精髓，只剩下一些俗气的烂梗~	正面	负面
好看，比原版漫画好看多了，更适合中国口味，每个细节演员道具都很棒，太空不再是遥不可及的，很好看	正面	正面
还不错啊啊啊	正面	正面
昨天去看了，又好笑又感人，可惜后面独孤月为了对付π＋牺牲了。这不是我想要的结局🙊	正面	正面
剧情十分好笑	正面	正面
好看，给力，奥利给，感动😭	正面	正面
沈腾真的太奈斯了	正面	正面
前面非常好笑😄😄😄，后面都给我看哭了🤣🤣🤣现在完全是沈腾的铁粉了🥰🥰🥰	正面	正面
剧情有泪点有笑点 真的真的很好看，独孤月，刚子，马蓝星，啊啊啊啊。	正面	正面
很好看，剧情也不错	正面	正面
超喜欢 推荐看	正面	正面
搞笑剧情好不愧是腾哥	正面	正面
影片很好看，值得推荐	正面	正面
剧本充满想象能力，就是爱情路线发展的有点迅速	正面	正面
这部片子争议这么大吗？我觉得超好看，我看过的沈腾演的最好的一部片子了。今年看的最好看的一部电影。	正面	正面
演技在线，沈腾yyds，剧情感人！	正面	正面
太好看了，演技太棒了 🌟 推荐  😊 演技  🌅 画面  😭 哭点  🎉闪光点	正面	正面
非常棒！围绕着袋鼠，地球，人情世故，展开的剧情！	正面	正面
让人哭笑不得	正面	正面
剧情好看，非常棒	正面	正面
好 推荐大家一起来看	正面	正面
我爱了我爱了	正面	正面
好，观影效果佳	正面	正面
好看，一边笑一边哭	正面	正面
挺不错的。。	正面	正面
前期剧情发展平淡，梗有点太密集了，后期强行感动。总体来说剧情一般，没有以前那些个开心麻花剧好看了。看了一半确实容易疲惫，哈欠打了好几个 #剧情 #独行月球	负面	负面
搞笑当中带着感动	正面	正面
「独行月球」才是开心麻花电影该有的样子。 这次的开心麻花，绝对能让喜欢他们作品的观众，心满意足的走出影院。沈腾和马丽时隔七年再次合作长片，不得不说，好的搭档即便不用面对面，也可以演出火花四溅。不过在「独行月球」里，比沈马组合还让我上头的，竟然是沈叔叔和一只与他相爱相杀的袋鼠。这一人一袋鼠在我看来，不仅是银幕年度最搞笑组合，还是今年到目前为止让我最为感动的一对CP。	正面	正面
大烂片，刻意的搞笑，笑点低的人可能会觉得好笑，尤其是小朋友，成年人怕不是傻子，才会笑出来	负面	负面
唯一不足的就是电影院的问题	正面	正面
哭了好几回。	正面	正面
特别搞笑，最爱沈腾	正面	正面
整体来讲很适合和朋友来聚餐，环境非常适合聊天，性价比挺高的⬆️	正面	正面
喜欢黄子韬演的黄子韬，好看	正面	正面
反转很多，很搞笑，沈腾和马丽的配合默契，虽然结局be了，但这应该也是他们最真挚的回应了吧！＼（^０＾）／	正面	正面
好看，有趣，又很感人，非常正能量的一部电影。 推荐观看!	正面	正面
打发时间看确实很合适 搞笑比较新颖还有点小升华 特效做的也不错	正面	正面
这真的是今年看过的电影里比较深刻的了，前面特别好笑，后面有些地方就好几次要把我看哭了，一直忍着没哭，但结尾那里氛围渲染的太好了，为了地球为了大义	正面	正面
剧情能接受，观赏度很高，值得推荐	正面	正面
特效太棒了吧，还有我们刚子太可爱了	正面	正面
沒看过！不知道好不好	正面	正面
会哭的一部电影	正面	正面
我竟然看了，就说句实话，不好看	负面	负面
还是很不错的！结局也在情理之中！没有为了圆满而强行改变～真的很好的！！！其实不完美的结局才是完美的！！有笑有泪，好看！！！（好喜欢刚子哈哈哈哈哈哈哈哈哈哈哈哈）	正面	正面
不错，搞笑了，很喜欢	正面	正面
超烂很烂非常烂	负面	负面
好看，感动。	正面	正面
一般般吧，主要是马丽一说话我就出戏，哈哈。沈腾还是自带喜剧效果的，不过都上月球了，还这么胖……最后一点，我以为合家欢，结果居然死了……😅😅😅	负面	负面
不错喔挺好看的	正面	正面
挺感人的，推荐	正面	正面
为啥要抄袭流浪地球！	负面	负面
call back了很多，回忆杀拉满 梗和反转更多，内核与搞笑兼顾 所谓希望，坚守，爱都包含在内	正面	正面
内容紧凑但是很有感触，比较于现在的电影，可以相信沈腾的演技，值得推荐。	正面	正面
真的很棒啊！！！	正面	正面
有时笑，有时哭，有格局，有生活	正面	正面
还行，挺一般的片子	正面	正面
二刷～ 哈哈哈 第一次没看够 今天单独再看一次😁 😭 哭点  😂 笑点	正面	正面
就那样吧！没有想像的那么好，也不差	正面	正面
还好😅……	正面	正面
不好看剧情很烂，还防流浪地球，像演小品一样	负面	负面
麻花出品，必属精品！	正面	正面
非常不错，挺好的	正面	正面
很好的一部电影，最起码我是这样认为，电影搞笑，故事又带有一点遗憾，要是独孤月真的回到地球多好	正面	正面
很值得去看.	正面	正面
想给20颗星	正面	正面
还可以，沈腾撑起了一步戏！	正面	正面
值得推荐啦啦	正面	正面
这种电影能打9.4？ 会不会像之前演的一个短片-视频通话时正在在田里干活，然后突然假装静止，说视频卡了的无脑搞笑！居然很多评论说，高！妙！有创意！…	负面	正面
挺好  非常好看 推荐	正面	正面
还行吧，没有预想的好	正面	正面
非常好看 看哭了	正面	正面
前半段笑哭，后半段看哭	正面	正面
还不错，结局还可以，比较搞笑	正面	正面
剧情非常好，非常喜欢马丽和沈腾	正面	正面
一个字 尬。	负面	负面
好看，搞笑	正面	正面
好棒，真的很好看的一个电影	正面	正面
一定不要因为一些事情做了个错误、是的时候就不一样吗	正面	正面
没人会是第二个沈腾 你可以永远相信他😇😇	正面	正面
还可以，有笑点，没事可以看看，不会踩雷！流浪地球更出彩！	负面	正面
好好看，不错……	正面	正面
超级好看，我心中腾哥最好的作品！	正面	正面
确实不错，含腾量超高，但是一贯强行煽情，不太喜欢	正面	正面
沈腾马丽的电影从不会让我们失望	正面	正面
跌宕起伏 笑点累点皆有 认真看 感悟活着二字	正面	正面
整体情节不错,值得推荐	正面	正面
不是为了搞笑而搞笑，不是为了卖惨而卖惨 作为一个普通观众来说，不错	正面	正面
不知道拍的什么，大家是来看喜剧的，不是被迫挤眼泪的，两个小时不知道看了什么	负面	正面
马丽沈腾赚足了我的眼泪呜呜呜额	正面	正面
好看感人 搞笑	正面	正面
一般呢 剧情过于简单。是我今年看的唯一一场全程在睡觉的电影	负面	负面
很好看 推荐去看	正面	正面
有看点，值得深思。	正面	正面
挺好看的，支持！	正面	正面
相当好特别是沈腾说的把脚给我抬起来	正面	正面
剧情很好，喜剧中显示出人类的伟大	正面	正面
不能说到底是HE or BE，喜剧混着现实，完美拥着遗憾，结局和流浪地球很像，英雄可以是一群，也能是一个，但我觉得这种超现实的个人英雄主义不是很值得宣，虽然其中群众的力量也功不可没，但是吧，囫囵下来个人的比重很大的，我觉得这部电影当喜剧看刚刚好，当真就输了。当然我也确实是按照喜剧看的～超现实的情节多，可是它是喜剧诶，就把那些个的“不正常”情节变成笑点。整场电影的基调还是欢快和谐哒～超级喜欢。 唯一的遗憾是彩蛋没看到QAQ	正面	正面
沈马组合，电影票房就有了保障。抱着不低的期待值来电影院看，事实证明确实很不错。 有笑有泪，虽然个别片段的逻辑有点牵强，但是整体给到我的鼓舞是更大的；“你不是（一个）人”那个场景，让我觉得我也是不被抛弃的独孤月，一瞬间热泪盈眶，还是会继续期待沈腾老师和马丽老师更多精彩的作品的！	正面	正面
马蓝星，带我回家。T^T	正面	正面
很阔以，推荐	正面	正面
超级好看，有笑点有感动，也感叹中国航天的伟大。	正面	正面
好好看撒 超级好看 我好喜欢好喜欢好喜欢 🌟 推荐	正面	正面
电影院整体环境还不错，再接再厉	正面	正面
没想到最后不是完美endding，猜错了，笑点不少，但是夏洛特难以超越	正面	正面
很好看，又挺搞笑的，超爱沈腾	正面	正面
非常好看笑点密集	正面	正面
太差劲了，是不是没有其它选择？	负面	负面
沈叔叔太好玩了	正面	正面
前面比较搞笑，后面有点无聊	正面	正面
不错不错建议观看	正面	正面
电影还可以，主要是跟喜欢的人去看就觉得行！	正面	正面
确实很不错，在欢笑中有着感动，在感动中又掺着浪漫，有泪点，有笑点，真的是很不错的一部电影！	正面	正面
还可以。没想到沈腾马丽竟然没啥同框的戏份	正面	正面
爆米花电影，看着挺热闹！银幕画面很不错，特技也很炫目，值得去电影院看一场	正面	正面
“沈马”组合果然厉害	正面	正面
把脚给我挪开！	正面	正面
太单调了这个	正面	负面
还行。。。。	正面	正面
还不错，值得看。暑假带小孩去看也是很不错的	正面	正面
不错不错👍🏻	正面	正面
别来沾边！鸡皮疙瘩起两小时	负面	负面
剧情紧凑，幽默又有含义。孩子喜欢看。	正面	正面
前期很搞笑 后期真的很感人 沈腾马丽演技依然很好 从这电影悟出来要以大局为重 在国际和全人民面前 个人儿女情长都排在后	正面	正面
可以 搞笑哈哈哈哈哈	正面	正面
挺好看的，蛮笑场	正面	正面
情感渲染很到位，喜剧片也一定程度上掩盖了科学需要的合理性，独孤月一个人的寂寞和地球上众人万众一心的地方让人有些通感	正面	正面
基本是从头笑到尾！就是最后的结尾有点像流浪地球结尾！！！	正面	正面
真不错，量超级足，相当满意，继续保持噢🌞真不错，量超级足，相当满意，继续保持噢🌞	正面	正面
总体故事很不错	正面	正面
拍的还挺不错得，有些剧情让我也替男主捏着一把冷汗	正面	正面
个人觉得很不错啦。有情怀、有笑点、有科幻、有人性的善。已经很好了。	正面	正面
剧情幽默在线，航天知识到位，值得一看	正面	正面
门口就可以停车，停车位也很多，非常nice	正面	正面
即便是喜剧，也得讲科学啊，其他还不错	正面	正面
看的非常开心。	正面	正面
好看的，含腾量很高 就是看着还是很乐呵，有笑点也有泪点	正面	正面
演技在线，剧情一般般	正面	正面
模仿国外的一部，完全无法比，太**了	负面	负面
还是值得一看	正面	正面
额 不太行啊	负面	负面
一般般很一般剧情不怎么样，不是很好看，真的很一般 🥚 彩蛋	负面	负面
好笑也感动的	正面	正面
服务极差，前台沟通能力也是令人无语😓第一次来也是最后一次。	负面	负面
很棒，喜剧背后往往是悲剧，尤其是最后英雄时刻很感动	正面	正面
还可以吧，挺不错	正面	正面
一个人好好看加油加油	正面	正面
夏洛特烦恼，西虹市首富，独行月球，含腾片百分百，又是一部爆笑的暑假电影，看了点映，电影院里全程笑声不断，炎炎夏日，去看一场开心电影吧	正面	正面
个人觉得还算可以，但是最后我睡着了。。。	负面	正面
挺好笑的有笑点值得一看	正面	正面
有笑有泪，挺好看的	正面	正面
前面笑的没心没肺，后面哭的撕心裂肺	正面	正面
搞笑可以，但是剧情和火星救援很相似。借鉴了很多电影桥段。总体来说有点遗憾	负面	正面
真的非常好看，值得推介	正面	正面
这个真实与喜剧参半，真的不错	正面	正面
含腾量100%也太好看了吧，看的人既笑又哭又热血沸腾的，到最后直接哭死😭😭😭	正面	正面
电影比较好看 电影院不好 VIP厅沙发是坏的 坐着非常难受	正面	正面
今年看过最好看的电影	正面	正面
可以，好看。	正面	正面
剧情好看搞笑	正面	正面
和好朋友相聚真的太适合来这了，每年都会来两三次，已经成为我的聚会必备了地理位置好，出行都很方便，而且团购的券也很划算，推荐大家来体验！	正面	正面
很好，有意思	正面	正面
可乐好看感动	正面	正面
剧情搞笑中不失悲伤🙁，悲伤中不失欢乐。	正面	正面
真的很好看，但爆米花是真难吃🙄	正面	正面
画面不错，特效不错，场景不错，其他就...	正面	正面
不是我喜欢的，没内容	负面	负面
后期制作确实突破以往国产水平	正面	正面
还可以，有时间去看吧	正面	正面
又搞笑又感动 振奋人心	正面	正面
一般般了 了	负面	负面
有欢乐 有感动 看到了 不放弃 牺牲的精神	正面	正面
好 非常的好	正面	正面
挺搞笑，震撼	正面	正面
还不错，还不错	正面	正面
挺好，看着很开心	正面	正面
特别好！沈腾和马丽的片子必看！真的特别有感觉，该哭的时候催泪，搞笑的地方也不少，真挺好，期待下一次她们的合作！	正面	正面
结局挺好的，	正面	正面
含腾量好高的电影！原本以为沈马组合是最好笑的！结果神刚组合我觉得更好笑！！里面很多梗啊，还有一些联系上往常的作品~看完真的太喜欢刚子了，袋鼠真的好可爱！真的是全宇宙第一顶流！！！不过这个电影不是纯笑，还是有点感动部分~最后结局和流浪地球有点像咯！总体还是很值得推荐的！！	正面	正面
好看着呢！好看	正面	正面
又搞笑又感动 真的很好看啊家人们 中国航天人太不容易了！	正面	正面
好看，悲喜交加，跌宕起伏，最受不了这种，但还是觉得很好	正面	正面
画面非常好，	正面	正面
剧情还行，很搞笑	正面	正面
太无聊了。。。。不好看	负面	负面
没有喜剧表演的开心麻花	负面	负面
剧情搞笑，和孩子一起看的，孩子也很喜欢，喜欢沈腾和马丽的演技	正面	正面
“世界那么大，我们还会遇见”  起初的独孤月：马蓝星，带我回家； 中途的独孤月：马蓝星，待我回家； 最后的独孤月：马蓝星，代我回家。	正面	正面
本来以为是搞笑片，没想到是哭哭片，我出了电影院都还在哭！前面笑点也非常棒！刚子，咱回家了	正面	正面
一般般。别抱太大期望	负面	负面
电影还可以，更建议大家看赵石的原版漫画《独行月球》！内容更丰富点，后半部分更催泪	正面	正面
属实很失望，没啥笑点，还不如魏翔的这个杀手不太冷静！这么烂的剧本，不如别拍！！	负面	负面
不错 剧情 台词 人物刻画	正面	正面
还行  挺搞笑的	正面	正面
喜欢，OK啦！	正面	正面
非常好看，也很感人值得一看	正面	正面
硬拼的剧情，有点虚假和老套。	负面	负面
有笑有泪，中国式平民英雄再次拯救人类。沈腾和刚子的对手戏精彩捧腹，中国科幻又一里程碑。	正面	正面
电影不错，就是美团卖的票价贵，抖音只要29.9元	负面	正面
好看。期待下一部	正面	正面
好看！笑点多！	正面	正面
太好看了..	正面	正面
挺好看的，不错。孩子挺喜欢的。	正面	正面
非常好看，值得多刷几次	正面	正面
还没看到一半…直接走人了……无厘头不是谁都能拍的	负面	负面
我有朋友说，不是在月球拍的，我不信	正面	正面
沈腾个人不错，还是适合在王牌对王牌，这个剧情太烂太尬了，适合10岁以下的孩子看。	负面	负面
嗯嗯不错很好	正面	正面
挺好的，很搞笑，后面又很温情	正面	正面
还不错，非常好看	正面	正面
沈腾自带笑点。挺有趣的一部电影。黄才伦的角色很出彩。开心麻花就是开心。哈哈。	正面	正面
完全冲着沈腾去的，内容……	负面	负面
一般吧，还可以看	正面	正面
特别特别好看！！！ X2 为独孤月和马蓝星的爱情嘎嘎流泪 笑点不尬	正面	正面
真的很喽，强行尬笑，也就沈腾个人吸粉而已。剧情无搞笑，无聊可以看一看，别有太大期待	负面	负面
含腾量比较高	正面	正面
我觉得特别好，没有让我觉得失望，一开始觉得还挺有意思的挺逗的，到后来就觉得挺感动的，“待我回家带我回家代我回家”，我觉得这句话特别适合介绍全局的。	正面	正面
全局笑泪交加，马丽和沈腾一如既往演技在线，配合默契。值得推荐观看	正面	正面
。。。不能理解评分为啥这么高，真的很烂啊，和朋友两个不约而同地没看下去，都玩起了手机。朋友说是披着科幻片外皮的搞笑片，但我觉得，科幻的部分和好多以前的电影重合，搞笑也没做到多搞笑，主题也没啥内涵。浪费时间	负面	负面
差点因为网上铺天盖地的黑评放弃去看了…看完后，我和侄子感觉都不错呀，怎么那么多黑的呢？做为喜剧片，能够戳中笑点，就很好了…也有感人的高光时刻，画面有唯美也有宏大，能让人又哭又笑的共鸣看完，个人还是挺喜欢的，明战完全不能比	正面	正面
昨晚看过了。情节简单，场景单一，喜剧元素全凭沈腾的喜剧演员人设支撑，笑点牵强(笑点不够，袋鼠来凑)，手法还是开心麻花一贯风格。马丽演责任重大的总指挥，再表现严肃，也看着让人出戏。除了月球场景和月球基地场景花了点心思，其他都是后期特效。这部剧三十多块一张电影票，撇开开心麻花的名气和沈腾、马丽的票房号召力，本身只值二十块钱的票价。	正面	负面
真不咋地，太一般了	负面	负面
还不错，可看	正面	正面
一般吧，希望更好	正面	正面
画面太美，人物形象好气质佳	正面	正面
腾式幽默很明显，加上高科技元素，挺有新意，全程无尿点，值得推荐！（马丽明显长胖了😂）	正面	正面
好好看看..	正面	正面
沈腾、马丽的电影越来越有意思了，评价高也是有理由的，该片搞笑、环保、有深意值得一看，小朋友也可科普月球、陨石、基地、空间等知识。值得一提是与袋鼠互动乃全片最励志、最搞笑的片段。	正面	正面
剧情真的很棒	正面	正面
很有意思的一部喜剧	正面	正面
结局不太理想，男主要存活下来就好了😁	正面	正面
推荐看，不错！	正面	正面
打发时间可以，但是不要追求质，还不如夏洛特烦恼	负面	正面
喜剧效果还行	正面	正面
剧情情理之中，没有啥意外，但是情节非常感人，感情到位。 人类的确很渺小，虽然有生之年经历不了这些事，但是希望人类能够珍惜，热爱大自然，并且找到可以生存的下一个星球	正面	正面
好看。细节满满的搞笑电影值得推荐一下了	正面	正面
没那么好看 笑点基本集中在袋鼠	负面	负面
很好笑。就是后面有点强行煽情了	正面	正面
看到最后时跟儿子说：我不能接受独孤月死了，回去我要打个差评！儿子还劝我不能这样。开玩笑的，怎么可能差评呢？虽然不算十分满意，评分十分还是要给的。	正面	正面
很好看，里面有地球和月球，还有独孤月，讲述了独孤月从平民变为英雄的故事 🌟 推荐  😊 演技  🌅 画面	正面	正面
真的很不错  很推荐	正面	正面
好看，笑点很多	正面	正面
挺好，可以看看	正面	正面
剧情搞笑又充满泪点	正面	正面
剧情笑点多，泪点多，总的来说满意	负面	正面
喜欢！太爱了	正面	正面
有笑点 腾叔魅力无限 有泪点 拯救人类的大爱和永不放弃的精神很鼓舞人 ,值得一看	正面	正面
看完这部电影，最大的感受如果想做成看似做不成的事情你的内心要装着希望。就像原本要往东走的计划只有往西走才能成功。看似最倒霉的事情也可能是最幸运的事情。事物都是两面性。最后电影里的很多画面很唯美，特效非常精致真实，笑点不落俗套。我喜欢它星空的画面，真的有在太空中傲游的感觉。观影到一半的时候以为独孤月会回到地球，以为影片是绝处逢生的主题，没想到是自己格局小了，牺牲自我成就世界是独孤月这个孤独的角色最伟大的呈现。	正面	正面
很棒，剧情很有意思	正面	正面
剧情新颖，笑点泪点并存 ，沈腾马丽yyds	正面	正面
真心不错呢，值得推荐，一直都喜欢沈腾马丽，这次也一样	正面	正面
整体不错，虽然有几处画蛇添足，但瑕不掩瑜。期待开心麻花下一部沈马合作！！！	正面	正面
感觉很好看，不觉得像他们说什么卖情怀啥的，感觉非常值票价	正面	正面
超级好看！很搞笑也很感人	正面	正面
特别搞笑，特别有逻辑，太搞笑了，比较适合孩子看，对孩子有教育作用	正面	正面
很好看令人感动，	正面	正面
好 好 好👌🏻	正面	正面
好看，感动的一塌糊涂	正面	正面
好看，真的很精彩！	正面	正面
有笑点有泪点，两位都是很不错的演员，电影里每个人都是主角，刚子的表演也很棒	正面	正面
剧情很好，有搞笑，有感动😭，精彩	正面	正面
剧情紧凑，流畅，感人	正面	正面
你这句善男信女奶凶奶凶你到哪	正面	正面
有几句台词感人！	正面	正面
特别好看，可以永远相信腾哥，笑点泪点都有，早就说腾哥的电影一定要支持，做到了，没有失望，非常棒	正面	正面
笑的眼泪都出来了。	正面	正面
感觉很平淡啊，有点小失望，我兄弟坐旁边都睡着了，哈哈	负面	负面
很好看，情节感动，情理之中，意料之外	正面	正面
1分我都不想给，越看越没劲，假的离谱。也不知道你们的好评怎么来的，看的我尴尬症都犯了。太烂了	负面	负面
真好看嘿嘿嘿嘿	正面	正面
前面还好，就是后面不好看了	负面	正面
可能是我的原因吧，我觉得不好看	负面	负面
很搞笑，适合去放松	正面	正面
喜欢搞笑部分，笑死了都，尤其是给刚子配音那里。 就是后面好可惜独孤月没有活下来。	正面	正面
超级好看，强力推荐	正面	正面
报看……….	负面	负面
喜剧的核心还是悲剧	正面	正面
很棒的，看了半天	正面	正面
先笑后哭，还有不错的	正面	正面
很好看！非常好看！	正面	正面
挺搞笑，喜欢沈腾，刚子塑造的很有意思，结尾有点煽情，我希望能一直笑下去！！	正面	正面
不错，很棒。	正面	正面
不错，挺好❗	正面	正面
麻花团队，真的超细节，科幻大片。在电影院看真的很爽！	正面	正面
搞笑又感人 真的很不错	正面	正面
真不咋滴，逻辑性一塌糊涂，特别假，笑点也不多，还是觉得沈腾之前演的电影好一些。虽然最后有些感人，但是由于影片逻辑性弱，也就不觉得感动了，太假	负面	负面
中国人的浪漫，沈腾和马丽的搭档绝了都！值得票价😎有笑有泪，棒棒棒！	正面	正面
好看，沈叔叔果然没让我失望	正面	正面
好看还特感动	正面	正面
非常好，包装很好，喜欢的小伙伴么快快下单，量很足，味道很好啊！已经是第二次购买了，真的很好吃哦！	正面	正面
很好看，笑点多也不低级，沈腾yyds	正面	正面
不好看，强行搞笑	负面	负面
前期很搞笑，后面很感人，为了我们的家园，让我们一起保护它。。	正面	正面
超级一般，爆米花剧	正面	负面
感动到眼泪水止不住	正面	正面
还行   没有沈腾以前的搞笑了	正面	正面
爱死了 🌟 推荐为沈腾马丽买账👍🏻👍🏻👍🏻  😭 哭点“马兰星，带我回家”😭😭😭  🥚 彩蛋“宇宙人类”	正面	正面
画面很好，很好笑也有哭点	正面	正面
搞不懂笑点在哪里	负面	正面
世纪大难看难看	负面	负面
从头笑到尾，还不错	正面	正面
好看，前面搞笑，结尾沉重	正面	正面
很好看，年度好评！！！	正面	正面
棒，很棒很棒	正面	正面
下饭剧	正面	负面
特别好看，特效也很棒	正面	正面
既不好笑，也不煽情，全靠炒作，个人感觉还是这个杀手不太冷静好看，反正全程我是一下都没笑出来，就觉得尴尬	负面	负面
结局是真的没想到，本来以为剧情会按照自己想象的发展，结果并没有，真的挺出人意料的！我挺喜欢这种不按套路出牌的，一个摆烂的“中间人”最后还能念着人类想着大义，很振奋人心，笑与泪并存	正面	正面
也就那样，还行吧，	正面	正面
很好看，不错的	正面	正面
值得看，非常值得看。整个剧情很顺，情绪跟着剧情走，节奏刚刚好，中间感动了好多次，留泪好多次，现在在回去的地铁上单曲循环《回家之路II》， 我的肩膀背的起银河的重量， 却背不起一滴你想念的泪光。 马蓝星，带我回家	正面	正面
还行吧！就是后面	正面	正面
不错 不错 .	正面	正面
很好看  全程看的很过瘾	正面	正面
整体店里的环境很好，采光也不错，📷蛮适合拍照的	正面	正面
很好看！有笑点有泪点，最后还升华了主题，不戳！	正面	正面
有笑有哭，好笑好哭！	正面	正面
带孩子一起看的。觉得很不错！沈马组合yyds	正面	正面
挺不错的建议大家都去看（含腾量百分百）	正面	正面
还不错   效果很棒	正面	正面
非常不错 🌟 推荐	正面	正面
很搞笑，就是老沈挂了不是很舒服	正面	正面
可以去除，我们的生活	正面	正面
剧情精彩，搞笑	正面	正面
为了沈马而来，但是还是期望太高反而会失望。魔幻元素太多，也有很多其他电影的影子，包括火星救援和流浪地球。只能说它在及格线左右，不算太优秀。	正面	负面
剧情还行吧！	正面	正面
沈腾在的话，质量有保证。	正面	正面
很好看 有笑有泪	正面	正面
作为一部备受期待的喜剧电影，《独行月球》还是不错的，能让观众时不时地被逗笑，已经很不容易。遨游太空的独孤月是惊喜交加，更何况还有“刚子”这样威猛可爱的伙伴陪着！在CGS中国巨幕厅观看，值回票价！	正面	正面
爱护地球，保护地球，腾哥做了次伟大的牺牲	正面	正面
影片很不错…	正面	正面
特别好看，也特别好笑	正面	正面
喜欢，笑中有泪	正面	正面
剧情不错，演技更棒。	正面	正面
非常好看，非常喜欢	正面	正面
孩子很喜欢，从头笑到尾，沈腾演技真心可以，辣目洋子不够出彩。	正面	正面
总得来说没有夏洛特烦恼那么搞笑，不过不错的一部电影！	正面	正面
非常好👍前期是今年目前笑点最多的电影，都是笑的前仰后合的，笑的肚子疼，后期较为感人。影片没有一处拖沓，特效在线，演技在线，值得一看的好电影 🌟 推荐  😂 笑点  😊 演技  🎉闪光点	正面	正面
最后的一段差一点预期效果。	正面	正面
好笑就完了，	正面	正面
真的很一般的	负面	负面
太好看了，推荐	正面	正面
挺搞笑的好看	正面	正面
非常好看，感动哭了我	正面	正面
包场表白，电影没认真看。	正面	正面
我只能说还行。	正面	正面
好看😊！！	正面	正面
剧情还可以，笑点挺多。	正面	正面
一般般，就这样	正面	负面
非常棒的剧情，完全不止简介介绍！！！！直击你的内心！不是简单的喜剧！值得去电影院看电影	正面	正面
冲着沈腾，马丽主演过去看的，刚开始还是蛮有喜剧效果的， 越到后面越索然无味了，各种心灵鸡汤，抒情了！	正面	正面
好看  特别好看	正面	正面
还行吧，看看	正面	正面
很不错，前面搞笑，后面感人！	正面	正面
电影延续了开心麻花的风格，剧情怎么说呢，还行，结局有点老套，还是挺搞笑的。	正面	正面
虎头蛇尾，满分开局，仓促结束	正面	正面
开心麻花、从不让观众失望	正面	正面
真的好看，前面搞笑后面泪崩	正面	正面
真的绝了，我愿称之为本年度最佳真的超好看	正面	正面
可以，可以，比上海堡垒好的不知道在那！！！！！！可以去看	正面	正面
可以……….	正面	正面
“这是唯一可以保护你、保护你们的方式。” 二刷才发现这是个悲剧，独孤月因对马蓝星一见钟情自降身份做维修工八年，后被遗弃在月球两年，本以为可以重返地球却为了保护地球家园和自己爱的人而英勇牺牲。片尾地球人重建家园，立起袋鼠碑像纪念，也许除了马蓝星没有人还记得这位为了地球而牺牲的英雄。 🌠在平行宇宙里～ 愿所有的付出都值得💌 愿所有心中有爱的人都被记得❤	正面	正面
好啊不不不呢	正面	正面
有辣目洋子这个汉奸就突然不想看了	负面	负面
很好啊，各方面都很好，为什么网上会有喷子说不好，不理解	正面	正面
虽然是搞笑片，但是特效也不赖。	正面	正面
又搞笑又感动，宇宙这么大，我们总会遇见	正面	正面
电影好看，问题是华夏影院什么时候能改进下，18:00的电影，18:05分了还没放映，非要观众打电话催才去放吗	正面	正面
很好看，可能是今年暑假最佳电影了。又好笑又感动又浪漫，兼具人文与科幻。其中的宇宙，月球科幻部分可能比一些所谓的科幻电影更好。	正面	正面
很喜欢这部电影。含腾量100％，沈马组合非常好看。这部电影让我看到了人与人之间的互助。前期的独孤月给地球上的人们鼓舞，中期人们给独孤月光，让独孤月不感觉孤独，后期独孤月孤身面对陨石，这些让人看了都很感动。独孤月和袋鼠刚子也让人很喜欢，不离不弃，不抛弃，不放弃，也让人很感动，最后独孤月把生的希望留给了刚子。全片喜剧气息非常浓郁，让人看到了沈腾和马丽的经典搞笑组合，也让人看到了电影中的温情，很喜欢这部电影。	正面	正面
一如既往的搭档，喜剧满满	正面	正面
很好看，值得去看！搞笑又感动	负面	正面
很搞笑，笑的肚子疼，搞笑还得是沈腾和玛丽	正面	正面
笑点蛮多的，不愧是“沈马”组合，默契度蛮高的，“刚子”演技也不错，影片结尾的时候被小小感动了一下，因为是工作日，观影人不多，但是影厅里还是笑声不断。不剧透，喜欢就自己去看吧！	正面	正面
挺感人的！演员真不容易！别说什么笑点低，什么想都能想出来的，这部电影也不是让你们看就是搞笑的！沈腾跟马丽合作就是票房的保证！很喜欢这个电影！	正面	正面
想哭想笑…	正面	正面
没想到是be的结局  很感动虽然没哭也很好笑笑得很大声但没吵到其他人哈都在笑 很好看就是了 good	正面	正面
就是最后挺可惜的，整体搞笑，音质入心，代入感很强烈，很喜欢。	正面	正面
全部是水军评论、可惜我花了90元买票！太烂了！烂片	负面	负面
真不错，相当满意，继续保持噢🌞	正面	正面
搞笑也感动	正面	正面
还可以！！！	正面	正面
好看好看！太好看了！又感人又搞笑，结局虽然凄美但是很符合逻辑！开心麻花电影准没错！比以前的更好看了	正面	正面
不错画面感强，挺感人的	正面	正面
好看 感人至深	正面	正面
嘎嘎好看有笑点有泪点	正面	正面
笑点那么高的我都笑抽了好几次🥳	正面	正面
国产喜剧最喜欢的就是沈腾。	正面	正面
还可以  剧情很俗套  但能看	正面	正面
还可以挺搞笑的就是结尾有点感人	正面	正面
我的肩膀背得起银河的重量，却背不起一滴你想念的泪光。。。	正面	正面
很好看，内容丰富多彩	正面	正面
剧情还可以。	正面	正面
真的不错！！ 强推！真的有被震撼到 沈腾的参加让这部电影有哭有笑 当然 他和马丽也好甜呜呜呜	正面	正面
太棒了，很好看，也很感人！	正面	正面
比流浪地球差太多了，逻辑不同还尬笑	负面	负面
一般般，挺搞笑的	正面	正面
剧情也就那样吧。。。。	正面	负面
不太好看，全程一直在强行催泪，强行搞笑，很僵硬，真的太失望了！	负面	负面
真的好好看  妈耶  推荐	正面	正面
超级棒啊，爱了！ 🎉闪光点  🌅 画面  😊 演技  🌟 推荐	正面	正面
公共工程采用v营业	正面	正面
开心麻花，没让我失望。这次是喜剧中还带着泪点。很励志。	正面	正面
结局是个遗憾	正面	正面
含腾量非常高哈哈哈，袋鼠也很可爱	正面	正面
靠明星，靠流量，靠宣发，靠大公司。电影应该是内容为王，不是靠人为手段。	负面	正面
真心推荐，又笑又哭的	正面	正面
有笑有泪，宇宙级的浪漫。	正面	正面
多少年没有一部让我笑出眼泪的电影了。平淡枯燥压力大的生活 适合大笑来释放	正面	正面
必须满分💯   剧情太棒了	正面	正面
非常好看，喜庆，幽默风趣。在一个只有自己的陌生环境生活也要有信仰和航标，而且要活的有价值，当然还得有文化，有实力，如果你啥都会，也要有个一技之长，这样才能按照航标一直行驶才不会偏离轨道，直到生命的最后一刻，也不忘记自己还有帮助更多的人，也可以创造奇迹。	正面	正面
全程笑点不断	正面	正面
还行吧，当个喜剧看看	负面	正面
剧情一般，为了搞笑而搞笑	正面	正面
笑点泪点十足	正面	正面
没缝流浪地球也没缝火星救援，好事。但故事依旧还是开心麻花水平，不过视效不错，多给一分	正面	正面
剧情很好，前面是搞笑的，后面比较伤感	正面	正面
比较搞笑，但是不符合科学	负面	正面
挺好的，让人心情愉悦	正面	正面
今天也是元气满满的一天 啊～～～	正面	正面
有故事，有爱情，有科幻，震撼，有哭有笑，好电影	正面	正面
很不戳，特效很棒，喜剧很喜，给满分！	正面	正面
开心麻花组合果然才是yyds！ 🌅 画面：这次是科幻片，画面质感还是很有保障的，一点也不输那种3d。  😭 哭点：腾哥在独自一人推宇宙之锤往陨石方向唱起那首歌的时候，眼泪都止不住呀，平凡而伟大。   🌟 推荐：百分百支持腾哥跟丽姐👏👏👏	正面	正面
小刚！我来啦！	正面	正面
科幻与幽默，故事情节演义的好	正面	正面
搞笑与感人相结合  到了最后会留下眼泪  前面大多数的是搞笑	正面	正面
🌟 推荐含腾量极高 😂 笑点过程很搞笑	正面	正面
金刚鼠很好，沈腾和马丽一如既往的演技在线，搞笑担当，值得观看👀	正面	正面
很好看！值得一观	正面	正面
不擦不擦沈腾出马必看	正面	正面
沈马组合永远不会让观众失望！	正面	正面
真的超级超级好看 没有之一	正面	正面
非常喜欢沈马的演技	正面	正面
好看值得购买	正面	正面
剧情流畅，有很多搞笑的部分，腾哥一出来就是笑点。推荐观看	正面	正面
非常好，欢笑，感动	正面	正面
沈腾自带喜剧很好看	正面	正面
偷明日的票房…可耻…	负面	负面
笑点一般，结局很出人意料！	正面	正面
演的不错。好看。期待下一步作品	正面	正面
麻花团队太牛了！	正面	正面
很好看。值得推荐大家看	正面	正面
那好看的都快把我给看死了。	正面	正面
不错，很好看，剧情不错	正面	正面
很好看，剧情搞笑，结局比较伤感	正面	正面
很不错的一次观影	正面	正面
好看的片子，	正面	正面
必须打个满分💯	正面	正面
有笑点有泪点，全程无尿点，真的很感动	正面	正面
比较煽情，喜剧戏份比较少	正面	正面
开心麻花也开始不让人开心了	负面	正面
适合情侣观看	正面	正面
笑死我了   搞笑的很	正面	正面
真不错啊！孤独是常态啊，越是接近创世神的精神世界，越是倍感孤独。	正面	正面
一般笑点太尬	负面	负面
演技可以，搞笑之余很感动	正面	正面
前面挺搞笑的，后面有点感人	正面	正面
挺好的，有点贵	正面	正面
好看，过程无尿点	正面	正面
不错，很搞笑	正面	正面
路过这边不知道吃点什么，就选了这家，吃了那么多家，这是我吃过最正宗的一家了，味道纯正，口感顶级，价格便宜。 经常在你店里买，味道不错很好吃，分量很足，价格便宜，及时送达，包装完整，服务态度好，下次再来，五分好评。	正面	正面
感觉题材比较新颖，但是觉得煽情部分有点多。奔着戏剧去的，再有就是结局不够完美。整体还可以有笑点有泪点	正面	正面
好看，也很感动	正面	正面
绝了  很好笑	正面	正面
不错啊，很好看	正面	正面
有被笑到有被哭到⊙﹏⊙	正面	正面
还行，能理解那种感受。	正面	正面
非常的好看 含腾量百分之99	正面	正面
好看，搞笑又有点悲剧！	正面	正面
高开低走，后期模块化	负面	负面
一般吧，不过还是要支持沈腾的	正面	正面
就是恋爱到月球	正面	正面
毫不犹豫给这部含腾量超标的电影10分。演技、音乐、中国巨幕相得益彰，独孤月和刚子一个包袱接着一个包袱让观众的笑声此起彼伏，很是过瘾。一个所谓平平庸庸，碌碌无为的“中间人”，以“中间人”的方式拯救地球，鼓舞人心，这就是中国的英雄！电影的题材也让我联想到中国的航空航天事业正在飞速发展，近年来，我国的航天事业更是取得了日新月异的进展，希望能实现更多的中国梦，希望祖国繁荣富强！	正面	正面
有搞笑  有感动	正面	正面
电影好看，但是影院差评。怎么一场还没有结束，下一场的人都进来等位置了……这让我们看精彩彩蛋的多尴尬	正面	负面
还得是老搭档更有默契啊	正面	正面
挺搞笑的，挺好看的	正面	正面
真的就一烂片，巨尴尬。	负面	负面
好好看！前面搞笑着，后面就燃起来了，呜呜呜，演技炸裂，腾叔就没让我失望过	正面	正面
好看，喜欢……	正面	正面
挺不错的，含腾100	正面	正面
剧情一般 不搞笑	负面	负面
🤔！你是什么神仙姐妹一起走过	正面	正面
一人一鼠，包揽整场笑点	正面	正面
非常好，有笑点有泪点	正面	正面
太好看了 有笑点也有泪点 太喜欢了 优秀	正面	正面
沈腾一个可以撑起一部电影的男人，又感动又搞笑。。不错的爆米花电影	正面	正面
太好看了！还想再看一遍	正面	正面
vUVu次vivivivivivo比v哦VB哦	正面	正面
好看喔，喜欢看沈腾和玛丽组合的影片。诙谐幽默又有深度 。系统说我再写59个字，就有机会被评为优质评价。可是我从来没有写过这么多字，好紧张，我该怎么办才能写到59个字呢？聪明的你能帮帮我吗？哎呀？怎么字数就够了吖？	正面	正面
很一般 后悔去看	正面	负面
有喜劇的原素,也有感人的場面,這個組合不會令人失望,值得觀看！	正面	正面
好看，特别好看	正面	正面
好看 又搞笑又感人	正面	正面
好看 配乐也很好	正面	正面
哈哈拉了，拍不错	正面	正面
不错呀，忙碌平凡的日子，能看到这样的电影挺惬意的。	正面	正面
看第二遍了。	正面	正面
很好看，喜欢的可以去看看	正面	正面
挺好看的，支持沈马组合	正面	正面
很一般，剧情也一般	正面	负面
食材特别新鲜，真的是超有诚信的商家，平台的优惠	正面	正面
不愧是沈腾老师，笑点和泪点具有，赞！永远支持沈腾老师！	正面	正面
好多的剧情都是在懂得中结束，或左或右，或前或后，总会有这样的摇摆不定，可你还藏在那里，不肯离去	正面	正面
泪点笑点都很多，极力推荐	正面	正面
超级好！又有笑点，又有泪点，特别推荐！	正面	正面
笑点是真的挺密集，沈腾马丽组合是真的好笑，沈腾镜头只要一出来就让人想笑了。剧情还可以，结尾有一点点不是那么让人喜欢，英雄主义啊，不变的套路啊。配乐不错，画面也可以，会推荐朋友来看	正面	正面
好看，真的不会失望	正面	正面
这么说吧：如果把里面的袋鼠换成狗，我高低坚持把电影看完了。故事背景，科幻元素所有都可以不在意。但是，起码，这是个喜剧吧，犯不上用动物煽情吧。	负面	正面
还不错！那你！！	正面	正面
剧情新颖，特效很棒，笑点泪点饱满，很浪漫，很棒！！！永远相信开心麻花！永远相信沈腾马丽组合！ 🌟 推荐	正面	正面
很喜欢沈腾，内容风趣幽默，笑声不断。后半段又有煽情部分，整体很不错，支持腾哥。	正面	正面
还行吧，煽情太多了，搞笑有点少	正面	正面
导演，咱能不能尝试一下靠别的吃饭	正面	正面
好，有看点，感动	正面	正面
太难看了，怎么评分这么高的，都没看完看不下去了	负面	负面
好看的哦 .	正面	正面
全程没有一点拖拉节奏	正面	正面
好看啊 支持沈腾 沈腾不要死	正面	正面
好看好看哈哈哈哈	正面	正面
题材可以，但是笑点都能猜到，不是特别搞笑	正面	正面
非常的好看！！	正面	正面
剧情特别感人，只是看了开头就知道结尾，没有太大惊喜	正面	正面
剧情基本上符合国产片的俗套，大概率故事没发生你就可以猜到如何发展了。个别情节及配乐还是比较搞笑的。反正最近也没啥好片子，凑活看吧。	负面	正面
沈叔叔出马，必是精品！很不错，是中国人对超级英雄的理解！	正面	正面
追着沈腾去的，好看！！！果然含“腾”量十足，又哭又笑的。 😂 笑点	正面	正面
值得观看，值得推荐	正面	正面
科幻片真的是人类终极的浪漫!	正面	正面
前面看得开心，笑点极多，后面有点感伤了，一部值得一看的电影。	正面	正面
沈叔叔太棒了    这对萤幕cp磕啦  感人  甜甜的  很感动.	正面	正面
这个看到我有点困	正面	正面
剧情挺好的，看了哈哈大笑。	正面	正面
剧情真的不错，可以说是从头笑到尾，也有很催泪哦点，真的值得一看	正面	正面
早餐种类非常多，而且看起来都很精致，感觉物有所值呀	正面	正面
搞笑袋鼠，浪漫情节	正面	正面
满分💯 我对沈腾就没有失望过 这部电影我给满分 1亿分 非常值得观看	正面	正面
沈马组合不会叫人失望的！搞笑煽情国家大义一概没落！最近疫情让人很疲惫！看看电影娱乐一下还是很不错的！ 另外说一句 对于磕沈马cp的人来说  这个电影算是圆梦了哈哈哈哈哈	正面	正面
中国也有自己的科幻电影了！不再是好莱坞独大的时代了！咱们也可以塑造自己的救世主！喜剧科幻电影可是世界首创，加油中国电影！	正面	正面
有点无聊，剧情前面有点乱	负面	负面
我觉得这部电影传递的能量还是不错的，不单是喜剧片	正面	正面
挺好的很有笑点	正面	正面
沈叔叔和马丽姐的演技太棒了！！！笑点泪点都有，一点儿也不尬，快去看！！！	正面	正面
降低心智，不推荐	负面	负面
好的喜剧片最简单的标准就是能让人笑，所以我给《独行月球1》10分	正面	正面
中国第一部喜剧科幻电影！剧情不俗，笑点有的能预料到，有的出乎意料，月球地名致敬了很多人，超棒！	正面	正面
好看  很好看   值得看 。 孩子老公都说好看	正面	正面
还行挺不错的	正面	正面
还可以值得票价	正面	正面
一部十分浪漫的太空喜剧电影，希望未来的喜剧像这样多种多样，越拍越好。	正面	正面
真的太喜欢这部电影了 沈马yyds 全程有笑点笑的肚子疼 也有泪点眼泪止不住的往下流  这次沈马没有让我失望 真的超好看  ps：这部电影里的马丽好帅	正面	正面
挺好的，能让你开心开心。结尾一般，强行煽情。	正面	正面
感觉一般般吧	正面	负面
后面很感人。	正面	正面
挺好的，可能我上班了，有心事了，这次没怎么get到沈腾马丽的笑点，但整个电影营造的悲伤氛围我是感受到了，特别是独孤月牺牲那段，真的哭死我了，唉。但我其实感觉爱情不应该成为独孤月在月球上的唯一坚持，也许应该还有更深层次的东西，别来杠我，我觉得还是有笑点，有悲伤的地方的，特别是那个你不是一个人被看成了你不是人的时候，我有被惊喜到。整部电影的特效我感觉挺好的，我惊讶到了。还是一如既往的开心麻花的风格，很好看	正面	正面
喜剧的方式描述太空的宏伟，比起那些鲜肉拍出的电影可谓大大的赞，期望导演，演员组给我们带来更好的电影！	正面	正面
真的不错😊	正面	正面
超级好看！好看	正面	正面
还可以，好看好看好看	正面	正面
我是奔着沈腾去看的，感觉不好看没有什么笑点根本不是喜剧片	负面	负面
沈腾，演绎得不错！其他配角就不怎么样了。一半喜剧，一半煽情，故事情节，整体还算靠谱！值得一看！	正面	正面
很好看 情节很棒 有笑点也有好感人的地方	正面	正面
很好看，很搞笑，后期很感人	正面	正面
天下何处最妖娆，烟雨漫江南。  天下何处最辽阔，秋风过塞北。  江南塞北，塞北江南，相隔三千里。  江南有个薄妆浅黛的采荷女。  塞北有个仗剑青衫的少年郎。  这一天，采荷女北上塞北。  这一天，少年郎南下江南。  路上擦肩，他笑她身着红裙，像朵荷花。  路上擦肩，她笑他身裹青衫，像个傻瓜。  萍水相逢，阳光正好。  相视微笑，怦然心动。  少不更事，欲言又止。  四目相对，擦肩而过。  从此，他们再未重逢。	正面	正面
两分给沈腾 两分给某个镜头好漂亮的马丽 还有一分给坚持看完电影的自己😥	负面	正面
挺好看的哦。	正面	正面
电影还可以，就是现在看电影要48小时核酸检测，大家买票之前问下再去，不然去了没报告看不了麻烦	负面	正面
比想象的要好看！笑点泪点都有，具体就不透露了，小伙伴们自己去观影，能看出来国内电影质量水平在逐渐提升👍🏻沈叔叔很棒，开心麻花团队很棒，希望以后可以看到更好的作品，期待值拉满！🌹🌹🌹🌹	正面	正面
无聊啊，快看睡着了	负面	负面
还可以的！！	正面	正面
满意 悲剧 浪漫主义	正面	正面
蛮好看的，真的觉得应该算是麻花最好看的一部电影，磕到了沈马的组合cp 觉得袋鼠刚子的猛男特征！ 觉得特效也觉得也很棒！ 没有怎么可以煽情，觉得蛮喜欢沈腾和马丽的配合！ 没想到李玟是唱这首主题曲的歌手真的听不出来，声音真的变化好大！不过也很好听！	正面	正面
可以搞笑感动并存	正面	正面
剧情实在太尴尬了	正面	负面
杠杠的啊！支持	正面	正面
沈腾马丽必须好看	正面	正面
七夕专场，有爱也有反思，每一个笑声的背后都是孤独与付出，一部电影，万人反思。 互相陪伴，相互成就，即使是一只袋鼠，即便最后的那份爱是失去，那一份执着坚定的选择，已经足以。 珍惜每一份遇见，好看，好电影，就是有点心疼男主。女主是幸运的，愿每一个姑娘都能被坚定执着的选择！	正面	正面
真的不怎地	负面	负面
不错，但并非预想	正面	正面
【《独行月球》沈腾离“真科幻”还有多远？】 《独行月球》注定会大卖，一来暑期档乏善可陈，就等着“沈马组合”来救场，二来这种科幻轻喜剧，有着相当不错的画面感：月球上深邃的夜空，一望无际的黑暗，圆形的盆地或凹陷，还有失重的画面感。加之，沈腾在喜剧上的技术已然炉火纯青，再不像“年轻的郝建”用力过猛。当之无愧的中国喜剧大咖。  但平心而论，《独行月球》作为科幻轻喜剧，“腾含量”更多的是喜剧，而非科幻。纵然制作团队100%全景模拟月球，依旧缺一点儿“真科幻”味道。这也不能怪张吃鱼和沈腾，毕竟，他们只能拍出自己认知以内的电影。中国现在的文化土壤，很难孕育出真科幻，比如吕克-贝松想拍一部《超体》，就能去一个诺贝尔奖获得者那里取经，或者干脆跑到硅谷，很多企业的实验室里存放着超越现实15年的东西。有时候，想象力这个东西，真应该是刺激而来的。  其实，沈腾离真科幻的距离，就是中国电影离真科幻的距离。如今我们也只能感谢先驱者，感谢他们的脑洞和一掷千金。套用阿姆斯特朗的话：这是沈腾的一小步，也是中国电影的一大步。况且，科幻不止于大场面和科技含量。#独行月球	正面	正面
没觉得特别好看	正面	负面
剧情感觉因为袋鼠提升了5分，内容中规中矩，和流浪地球套路很像了。	正面	正面
好看，开始搞笑，后期招惹眼泪🤣😭	正面	正面
只能说，就很棒。开演不到半小时，已经笑出眼泪了，沈腾这位谐星自带搞笑因子，出场就能被逗到，在该部电影中，沈腾有大篇幅场面，他把电影里的喜怒哀乐各种细节演绎得很到位，再加上和动物金刚鼠的配合，笑到飙泪。再说电影的情节，为保护地球防止小行星撞击，这个不着调的独孤月又展现出了伟大无私的一面，整部电影有娱乐，有意外，有感动，有激励，牵动着观众的情绪，是一部细致的作品，以后还会再复看的。	正面	正面
我是带着孩子一起去看的。全程是一边笑，一边被感动的看完。非常值得推荐一部电影！	正面	正面
特效画面很美，沈腾马丽演技不出意外的好！特别是沈腾，把独孤月的孤独、乐观、谦虚演活了	正面	正面
这种片子这剧本 纯忽悠钱	负面	负面
一般般，没有那么搞笑	负面	负面
剧情挺搞笑的，刚子	正面	正面
不错的，很喜欢看	正面	正面
能看，但不是特别推荐……	正面	正面
一般，太一般了。	负面	负面
应该很好看，	正面	正面
非常好看，爆笑全场	正面	正面
可以看一看，不错	正面	正面
不错很好！！！！	正面	正面
还可以吧笑点挺多	正面	正面
搞笑的剧情，悲壮的结局。故事情节搞笑，剧情悬念不强，过早猜到了结局！ 🌟 推荐	正面	正面
风平浪静的日常里岁月静好，在迷惘，绝望，甚至仇恨时，仍然能够做出温柔的选择，主观觉得剧情处理很不错，结局可以说是情理之中有点出乎意料，主演的演技不用说了，小配角的文戏也能被感染住给小妹妹小小打call🌹 应该是主打剧情并不是硬科幻，虽然看的是2D，但是一些特效画面还挺出乎意料的，不一定是震撼，有眼前一亮的感觉，推荐看看	正面	正面
好看呀还可以，真的这种题型也很新颖，可以去看真的很好哭也很励志还搞笑be美学绝了	正面	正面
刚子演的不错	正面	正面
剧情比较搞笑	正面	正面
剧情可以，能把我对象感动哭的电影就已经是好电影了	正面	正面
便不错！好片啊.	正面	正面
期待太高了，觉得沈腾和马丽一定能很搞笑，结果发现没啥笑点，自己明明是个笑点很低的人，后面的升华就是说英雄这几年看的太多了，已经无感。如果归档为喜剧片的话还是不好看的，我以为会比这个杀手不太冷静还好笑，结果差太多了	负面	负面
搞笑的同时，鼓舞人们，只要肯动脑，办法总比困难少	正面	正面
他两在一起演真的很配	正面	正面
嘎嘎好看 含腾量百分百	正面	正面
演技都还算在线，但剧情一般吧，有些地方还有点尬，有些人物情节觉得就算删掉也对剧情推进没什么影响，总之没什么事的话还是可以看看的	负面	正面
前半段笑点密集后半段主要煽情！很好了	正面	正面
上一次看沈腾电影还是西红柿首富，时隔四年依然能给人惊喜，就是本人泪点比较低，中间差点哭出声了。	正面	正面
没什么酒惊喜 没什么亮点	正面	负面
剧情突破想象力，很适合带青少年看，科技元素多多，画面特效制作出乎意料，笑点多多，又泪点多多，家国情怀，科技未来，爱情坚守融为一体，非常好看。	正面	正面
还可以不错的	正面	正面
很好看，影院条件也不错	正面	正面
剧情很丰满，演技到位	正面	正面
笑点与泪点齐飞～ 最后的“宇宙这么大 我们还会遇见”！戳中了我的泪点，总之，还是吸收了不少的快乐！	正面	正面
很好看 很搞笑 值得推荐的电影	正面	正面
煽情太过了，故事有点弱，笑点是有的	负面	正面
我感觉非常不错	正面	正面
超级好看的一部电影！沈腾马丽真是最佳拍档！笑点不断，又笑里含泪。儿子推荐的影片确实不错！现在很少有这么吸引人的影片能让他从头到尾完整看完了。演员演技一流！剧情一流！画面感一流！👍 👍 👍	正面	正面
还可作为一个	正面	正面
非常好玩儿  沈马组合从来不会让你失望	正面	正面
喜剧强行整悲剧结尾，强行拔高层次呗？告诉观众看，我的电影是悲剧结尾，我不是以前的无脑喜剧。啥也不是，真有你的	正面	负面
非常好，沈马就是最棒吗	正面	正面
还行 一般般	正面	正面
挺好看的，讲述的科幻电影，不过脱离现实太多了，月球上能看到地球的灯光？	正面	正面
还可以不错哦	正面	正面
整场搞笑片段太多了了，腾哥太搞笑了带孩子来看，全程也没打瞌睡，坚持看完了，不错值得推荐	正面	正面
感觉这个电影立意还是蛮多的，很多剧情反转，还有解决问题时那种激动和快乐也是真实的，感觉自己已经深深带入到里面的剧情了。他的搞笑剧情说实在不是那么多，但是该笑的时候也确实好好的笑了，这部电影确实有点东西，内涵丰富需要自己去挖掘。	正面	正面
真的好看！值得去看！	正面	正面
还可以！我喜欢刚子！！！	正面	正面
喜剧往往是最感人的…前期笑的很开心后期哭的很丢撵...还以为是he没想到是be...值得看看 (补一句不要带脑子看容易出戏...例如袋鼠有5根手指头，重力有悖科学，外太空能传音...)后面的几个星空非常好看	正面	正面
无聊至极哦，哈哈哈哈哈	正面	负面
没看完，孩子在哭，就走了😃	负面	正面
勉勉强强，打发时间可以，具体要说啥剧情那不都是扯么	正面	正面
很棒啊！！！！	正面	正面
这部电影如果换个人演肯定不会是这种效果，真的是又哭又笑，当年喜欢沈马组合，后来看着我磕的cp他们be了，真的心里好难受…银幕上看见他们同框就特别开心，这么多年的感情太不容易了，看着最后十年前沈腾给马丽的信，真的哭的好厉害！	正面	正面
巨搞笑。但是腾叔煽情就有点受不了了	正面	正面
定位不清晰，本来是搞笑电影，那你就单纯走搞笑。 那么你上面的地球上的灯光问题就可以忽略 你要走科幻或者感人，你就别扯地球大意 真正的好故事就是，无论主演是谁，故事是可以看的 这电影要不是沈腾，马丽主演，则注定是烂到家的电影。 而唯一支撑起电影的就是，这俩主演，准确说只有沈腾一个人。	负面	负面
好看。全程都很搞笑，笑喷了	正面	正面
剧情精彩，有幽默，有感悟。	正面	正面
画面震撼，有泪点也有笑点	正面	正面
超出期望值，跟夏洛特烦恼和西虹市首富比差的不是一星半点，甚至都没有飞驰人生好看，没意思	负面	负面
故事没讲好，还行。	正面	正面
烂片，还以为是一部很搞笑的电影，前三十分钟还好！后面就像感情戏一样，动不动就带领观众挥泪，差劲，这部电影看了确实后悔，个人观点	负面	负面
笑出鱼尾纹，值得看，精彩剧情，切合主题，让我们更加能够通过电影来了解月球	正面	正面
太尬了我的天	负面	负面
不错，沈腾叔叔没有失望	正面	正面
还不错很搞笑	正面	正面
剧情还是很好的，又搞笑的一面也有感人的地方，画面不错，值得大家观看	正面	正面
非常棒，很满意。	正面	正面
我觉得挺好看的，笑点拉满	正面	正面
就是抱着放松的心情去看的，真的觉得挺好看的，而且也很搞笑，只不过结局不是那么理想，但我觉得是合理的，总而言之是很值得看的。	正面	正面
剧情还可以，沈腾演技真的可以，笑中带泪	正面	正面
剧情很紧凑 前期笑点包袱很多 最后独孤月牺牲的那一段很感人 舍小家为大家 真的看哭了 另外加一句 袋鼠真不错 不愧是地球顶流	正面	正面
很不错值得去看	正面	正面
只能说还行 剧情有些无聊 不是开心麻花的实力	正面	正面
一般 觉得没有评价说的很好	正面	负面
一般，不是非常好看	正面	负面
笑点真高，差一点给我逗笑了	负面	正面
好看，有笑点有温情有家国大义，特效也不错	正面	正面
还可以吧！没有想象的好	正面	正面
值得观看哦！	正面	正面
很不错推荐！	正面	正面
有笑点，也有泪点，值得一看	正面	正面
，真的是好的呀	正面	正面
挺好了。可以开心好几笑	正面	正面
前面搞笑，后面感动	正面	正面
很好的暑假电影，值得带家人去电影院	正面	正面
电影五星，观影体验极差，女朋友一直在旁边烦人	正面	负面
"笑点有，泪点也有。你永远可以相信沈腾。虽然有很多致敬之前腾式经典的梗，毫无违和感。再现《西虹市首富》，要不要救夏竹的梗。也凸显了《我和我的祖国》中，沈腾""我去""精神。整体还是很欢乐的一部大片。超喜欢宇宙顶流 刚子。绝对是这个暑假最值得观看的电影之一。"	正面	正面
总得来说还是不错了，毕竟含腾量这么高的电影实属不易	正面	正面
太好了太感人了太值得看了	正面	正面
虽然剧情有些不合理，但最终还是中国英雄情怀式结局！再过俩个月我们的梦天实验舱即将发射，祝福伟大祝国！	正面	正面
很一般的剧情，没有新鲜感	负面	负面
🌟 推荐 今年科幻喜剧电影🔝	正面	正面
还不错，不愧是沈腾	正面	正面
好看，全程高能，不断反转，搞笑加感动	正面	正面
还是开心麻花的味道，挺搞笑的	正面	正面
剧情和环节设计很可以，有搞笑的也有感人的	正面	正面
贼棒！值得二刷 🌟 推荐	正面	正面
。。。很棒很好	负面	正面
剧情一般，看起来比较轻松	正面	正面
和老婆一起看得，讲真还不错，笑点没有夏洛特烦恼密集，但是有科幻加成，整体还不错，近半年最好的电影	正面	正面
不错呃呃呃呃	正面	正面
好123456	正面	正面
好看，适合一家人	正面	正面
搞笑又感人～	正面	正面
很好看很有趣	正面	正面
喜剧片，挺搞笑的，值得一看。	正面	正面
不愧是“沈马组合”，这“含腾量”也很是让人爽快，全程有笑有泪，一点也不尴尬，力推！	正面	正面
好看，特别的搞笑，后面还是蛮煽泪的，超级喜欢沈马组合，哈哈哈哈	正面	正面
还不错，前段有点有意思，最后有点感人，不像沈腾以往的片那么有笑点	正面	正面
沈腾要减肥了	正面	正面
剧情不怎么样，单一	正面	负面
刚子和爱妻月月的爱情故事演的很不戳，很喜欢！（希望会有下部）	正面	正面
还好吧，感觉还行，就结局有点～	正面	正面
挺好的，不错。	正面	正面
一点都不好笑…	负面	负面
迪加奥特曼既视感	正面	正面
很好看  中间特别精彩  腾哥的含腾量电影  真的有泪也有高兴😊😊😊	正面	正面
哎，唯一的情感波动就是和大刚分别的一幕…其他的没有啥感觉…我带俩弟一起去的，我中途睡了一觉，我弟也睡着一个，他说这是历史以来看电影唯一睡着的一次！还是他要求看沈腾的电影，这回踏实了，搞的睡着了哈哈	负面	负面
全程脚趾扣地，嗯煽情，我谔谔	负面	负面
好看，推荐，赞	正面	正面
带着眼泪出来的，有哭有笑，很感动。这一部电影足以让人原谅这两年开心麻花的烂片，永远爱沈叔叔！	正面	正面
不用报特别高的期待值	正面	正面
挺好的，剧情不错	正面	正面
好看好看！！！	正面	正面
沈腾马丽宇宙超级无敌浪漫	正面	正面
还不错。蛮搞笑的	正面	正面
失望，抱的希望太大，笑点很一般	负面	负面
剧情有创意，镜头拍的也都很有感觉，很细节，有笑点也有泪点，后劲儿挺大的，推荐观看	正面	正面
特别好。	正面	正面
剧情好 演技好 笑点高 也有哭点 还得是我腾哥 🌟 推荐  😊 演技  🌅 画面  🎉闪光点  😭 哭点  😂 笑点  📚 剧本	正面	正面
觉得可以 有笑点 但是没有想象的好 暑假上映是大卖点 放在平时不会票房这么高吧 爱琴海看电影真受罪 外面凉凉快快 里面像蒸笼 座椅靠背太高 我165坐上去头顶的无处安放 再也不去了	正面	负面
不得不说独行月球这部科幻喜剧电影给力了，喜剧部分真的可以把人笑趴下，不愧是沈马组合yyds ，特效方面有让人眼前一亮的感觉甚至能让你感到震撼，还担心这部电影会被特效拉跨但出来的效果简直爆赞，配乐氛围感十足超high的，最后的大团圆结局的设定一点都俗气简直完美。	正面	正面
非常好看，下次还会再来，好评！	正面	正面
搞笑吧，笑不出来，煽情吧，哭不出来。 确实含腾量100％，其他人都成纸片人了。 这部电影单一动线，剧情老土，假大空的正义，不要抱着高期待去看，还是可以的。	负面	正面
好👌！！！	正面	正面
剧情有点一般，场面很宏大，某些细节违背原理，有点违和感，无法代入进入，只能算一个科幻喜剧，更像是火星救援和流浪地球的结合体。剧本平平无奇，作为2D电影，无论特效还是剧情都不值这个票价。前20分钟整体效果还不错，后面1小时非常无聊，总体不太推荐	正面	负面
超赞，值得一看	正面	正面
还不错，所谓低分，就是没看过火星救援。看过火星救援，不觉得月球是烂片。国内拯救🌐 ，不错	正面	正面
呜呜好看的 就是居然be了	正面	正面
“刚子现在有点不正常”哈哈哈哈哈哈 很多人说不如夏洛  可我觉得两个并驾齐驱吧  这部电影从整体特效制作和想表达的立意都很棒  我并没有觉得强行煽情  一切都合情合理   很感动   面对宇宙每个人都是那了了星辰   感情戏也很自然  也没有刻意   独孤月用自己的魅力感动着马蓝星   笑点也很密集  都很好笑   可能我喜欢沈腾   也很吃这种开心麻花的风格吧   反正每个笑点我都有笑   很喜欢刚子  哈哈哈哈哈  它可是在浩瀚宇宙中陪伴孤独月走过漫长岁月的🦘	正面	正面
这个电影挺不错的	正面	正面
还不错 还不错	正面	正面
笑死人了，哈哈哈哈，不愧是马沈组合	正面	正面
剧情不错，值得观看。	正面	正面
好看，感人。搞笑中带着感动。。加油腾哥	正面	正面
太好笑了，开心麻花不会叫人失望	正面	正面
流浪地球的低成本制作 强行搞笑 无聊	负面	负面
特别好看，既搞笑又有教育意义。	正面	正面
真的很好看 而且非常感动	正面	正面
确实可以，含腾量极高	正面	正面
既搞笑又感动	正面	正面
有好笑的有泪点的，但还是过于个人英雄主义赶脚。	正面	正面
剧情新颖，整部剧只靠着沈腾的搞笑撑着，没有什么内容，打分8分。	正面	正面
假的 311	负面	负面
还行吧，还不错。	正面	正面
真的好看啊呜呜呜呜	正面	正面
没有剧情可言 前半段完全就是沈腾的单口相声 硬凹的梗 不知道为什么评分这么高 我是麻花忠实粉丝 从话剧到电影 但是这部电影真的是有失水准	负面	负面
中中吧，7分，	正面	正面
不错，值得一看	正面	正面
挺好看，前面搞笑，后面感动	正面	正面
好非常值得一看	正面	正面
挺搞笑的，就是沈腾最近演的戏都是悲情结局，有点心酸吧	正面	正面
好看好看好看。比较搞笑	正面	正面
太好看了，整部剧很紧凑，看了好紧张啊，全程笑点	正面	正面
好看，感人，搞笑，满分	正面	正面
前面笑得多欢，后面哭的就多难过	正面	正面
刚子 含腾量100% 太好看了 ！	正面	正面
喜剧效果还行，好多地方挺尬的。	正面	正面
沈腾➕马丽，票房保障。提个小小建议，希望下一部片子能全程爆笑，不要煽情。过度煽情了	正面	正面
和闺蜜一起看的，很好看	正面	正面
沈腾的电影一如既往的好好看	正面	正面
剧情很好，外表搞笑，内核悲伤	正面	正面
好！ 好好好	正面	正面
讽刺了中国航天技术，搞笑剧又不是太搞笑。	负面	负面
超级好看，很解压	正面	正面
挺搞笑的，蛮好看	正面	正面
还不错，公司同事一起去看的！！看完后心情也都好起来了！	正面	正面
很不错，笑着笑着就哭了	正面	正面
感觉还不错😊	正面	正面
经典路子，靠沈腾撑着	正面	正面
一般般吧，没怎么笑	负面	负面
不错！很感人！	正面	正面
搞笑、励志、感动、振奋人心的一部电影，值得一看。	正面	正面
蛮好看，剧情不错	正面	正面
非常好看，含腾量非常高，既搞笑又感人，值得推荐	正面	正面
让人一会儿笑一会儿的电影，沈腾就是票房保证	正面	正面
有搞笑也有感动 很不错	正面	正面
好 好看得很一	正面	正面
好评，跌宕起伏，搞笑中带感动，棒	正面	正面
真的吹爆这个电影，笑的时候真的笑不活，哭的时候也好好哭，原谅我词穷，真的太好看了	正面	正面
沈腾演的太好了	正面	正面
真的真的真的很好看！ 首先，我是冲着沈马CP去的嘿嘿，不得不说沈叔叔和丽丽的演技依旧很好，不管是他们擦肩而过时的星星眼，还是最后恰到好处的眼泪，真的很有代入感 电影的特效制作以及人物设定等都很不错，有笑点有泪点，而且笑点的质量高，不是一般的包袱 最让我感动的就是take me home，country road这段BGM响起来的时候，我的眼泪真的是哗哗地流 总的来说，这部电影在我心中占据了一个很高的位置，真的很值得去看哦~	正面	正面
太喜欢了💕	正面	正面
个人认为不好看	负面	负面
好看好看好看 把喜剧和科幻融合的非常好，笑点贯穿始终，都说喜剧的背后是悲剧，但悲剧往往更让人印象深刻	正面	正面
好看！！！！真的特别好看，剧情跌宕起伏，推荐！！	正面	正面
开心麻花组依然笑料不断，有喜有感，很不错👍👍	正面	正面
超级好看 值得一试	正面	正面
还可以，可以看看。	正面	正面
黄金搭档不会失望	正面	正面
超级难看   评分为啥这么高   我发誓2022结束以前不在踏入电影院   太失望了	负面	负面
很好还行有点科幻的意思	正面	正面
棒太棒了，好看	正面	正面
当个日常活动的休闲电影看吧	正面	正面
好看，感人	正面	正面
这个电影，挺好看的，结尾还特别感人，	正面	正面
😂 笑点，沈腾演技确实牛，笑点太高了，  😭 哭点，弄🉐️在场的人又笑又哭的，带着儿子九岁半他哭得比我还厉害，过程中很是感人，中途那段告白感动我了……也很喜欢那个袋鼠🦘，确实值得推荐大家观看，  🌅 画面，最后落幕的配音和星星画面好美好，但愿世界永远保持美好❤️  📚 剧本，棒  🌟 推荐一定要看，很少评论的，	正面	正面
演技应该不用说了吧，那是非常好，剧情也是一级棒	正面	正面
1111号的时候下班了，然后我就知道我也可以啊！我也可以🉑可以可以啊！你是的时候来	正面	正面
太好看了吧。我太喜欢了，看了三次，很好	正面	正面
为了看沈腾😂	正面	正面
挺好看！笑着笑着就哭了，哭着哭着又笑了！	正面	正面
挺不错的，可以	正面	正面
拍摄画面不错，特效做的很棒！！！	正面	正面
真心一般，怎麼評到9分多的	负面	负面
从一开始的搞笑到后来的流泪，我喜欢这部电影	正面	正面
剧情虽然不怎么样，不是特别搞笑，但是那种坚强，互帮互助的精神很好，还可以吧！	正面	正面
笑点挺多推荐	正面	正面
你可以永远相信沈腾和马丽，真的是宇宙级的浪漫，整部影片有笑点有泪点，演技都在线，还有金刚鼠，刚子我是真的好喜欢	正面	正面
剧情尴尬 垃圾	负面	负面
非常值得一看的电影。	正面	正面
很不错哦，搞笑点很多，共情点也很细腻	正面	正面
特效满分，虽然不是3D，但有点裸眼3D的感觉，看的又笑又哭的，很感人，喜剧中透着的那种感人其实更戳人！还有被刚子圈粉了😂太可爱了，感觉它有点像“美团配送”😁国产科幻片拍到这份上真不容易，给两百分！其实我们的科幻片如果把故事片拉长，就可以像国外科幻片那样，拍成“连续剧”了，不过单独一个独立剧情的话其实更经典，只是投入太大了	正面	正面
个人觉得特别棒，电影完了也没有把灯全部打开，很尊重观众	正面	正面
很好看去看家人们冲	正面	正面
沈叔叔演技在线，笑点哭点具备，特效是流浪地球的制作组制作的应该不用我多说了吧。挺绝的反正	正面	正面
挺好的，但是可能预期太高了，所以稍微有点失望	正面	正面
多的不说 都在电影里 演员不易创作不易 还会支持开心麻花及腾哥的作品  🌟 推荐  😂 笑点  😭 哭点	正面	正面
大屏幕，视觉效果挺好，人也不多。	正面	正面
有沈腾马丽的电影，从未令人失望~	正面	正面
全片两个高燃部分第一个是独孤月拉拉着刚子回基地第二个是地球给独孤月希望不过刚开始确实有点小尴尬（个人感觉）	正面	正面
超好看yyds	正面	正面
有搞笑，有感动，总体还不错	正面	正面
不错的电影，特效非常好	正面	正面
太幼稚，带我家孩子去看了，全程哈哈大笑，我却看不出有啥好笑，我老婆也说没意思，就是那种幼稚的搞笑吧，结尾过度煽情，真不建议去看，浪费时间	负面	负面
只为马丽沈腾	正面	正面
又哭又笑，很好看。	正面	正面
沈腾马丽的组合是最精彩的，笑点非常多，后期非常感人，非常精彩的一部喜剧科幻电影。	正面	正面
剧情极其无聊	负面	负面
如果10分的话，7分吧，没有想象中那么好看。	正面	正面
巨巨巨好看！	正面	正面
前期剧情很搞笑，后期剧情很伟大。	正面	正面
不好看  笑也不怎么搞笑 泪点也很尴尬哭不出来	负面	负面
不好看也不好笑	正面	负面
没有想象中那么好看	正面	正面
太强了吧，总的来说，我认为比流浪地球好。	正面	正面
绝绝子！笑点太多太密集，全程笑哈哈！中间还穿插着泪水~实在走心~结局算是be，我喜欢be，人生哪有那么多he~刚子实在圈粉~是我心中麻花的top1~赞！	正面	正面
推荐推荐，真心推荐	正面	正面
剧情很棒！又搞笑又感人！	正面	正面
挺好的  有搞笑  有感动	正面	正面
画面太美，观影愉快！	正面	正面
好哈哈哈哈嗝	正面	正面
太棒了，以为只是搞笑片，没想到和流浪地球一样硬科幻片，现在中国电影工业真棒👍🏻，还带催人泪下	正面	正面
怎么说呢！好看！！真的巨好看！毕竟这么高分，一上线就去看了！不能只我一个人看！信我的真的好看！！！！！！😃😃😃	正面	正面
真的超级好看，特别逗，全程笑着看完，结局哭了，大爱	正面	正面
感人，搞笑，演技不多评价，但是剧情赞	正面	正面
睡着了，不知道沈腾是怎么死的……	负面	负面
现场除了笑声，更多的是眼泪[大哭]突然的灾难，暗无天日，看不到希望，人们集体精神濒临崩溃……一个弃子，却成了精神支柱，谢谢Boss的拯救决策，谢谢沈腾没放弃……	正面	正面
含腾量超级高 建议去看	正面	正面
剧情太棒了  爆点很多	正面	正面
好看，值得一来！！	正面	正面
一部搞笑而感动的剧情~主角光环的影响~带动人心的时刻，每个为国家做出贡献的人都有奉献精神~为了救人民，不惜牺牲自己~浪漫感动的结尾挺好看的~	正面	正面
好看死了，二刷走起	正面	正面
好哈哈还哈哈	正面	正面
价值理念非常不错	正面	正面
超好看，笑哭了	正面	正面
这剧本有一定深度的哲学在里面 时间并不是合理的载体 结果也不是生命的价值 谁需要你又需要什么	正面	正面
真的好看得很	正面	正面
太棒了的电影了！	正面	正面
推荐推荐观看	正面	正面
很不错的一部电影，真是被腾化了	正面	正面
喜剧～让观众先乐啦、后哭啦～成功就是如此！	正面	正面
还行，有点搞笑，有点心不甘	正面	正面
嗯嗯你什么水晶滴胶	正面	正面
非常好jan	正面	正面
电影可以看 只是看一看就行 可以放松一下  只是开心麻花怎么沦落到靠翻拍来赚钱的地步了？ 但至少比贾胖子强多了  剧情开始可以到后来都能猜到八九成了 一般 不知这锅谁背合适  还能说啥只能说沈腾演得好 别的也不敢说 让只袋鼠抢了百亿票房的戏呵呵呵 知不知道袋鼠在澳洲活得可有意思了  让它把自己烤了给你助助兴?	正面	正面
完美 太完美了	正面	正面
沈腾的电影，永远都是那么成功，力挺！！	正面	正面
太搞笑了，沈腾的电影一直好看	正面	正面
剧情精彩刺激影院环境不错值得推荐	正面	正面
生造个袋鼠出来搞笑，生造笑点就没意思了	负面	负面
不错不错给哈哈哈哈哈哈	正面	正面
很好看，腾哥真的给我惊喜！特别有笑点，然后那些细节处理非常好，太空的处理非常美，刚子也很生动，沈马组合冲冲冲！ 🌟 推荐  😊 演技	正面	正面
个人觉得是开心麻花的一部良心大型科幻巨制喜剧电影。完美继承了开心麻花在嬉笑怒骂的搞笑之后，极致煽情。影片最大泪点就是沈老师饰演的男主独孤月，在本能回到地球的时刻，最后为了保护自己最心爱的人和家园，带着核弹冲向陨石碎片那一刻。让人不禁泪目。腾哥、丽姐、成儒老师的演技更是不用挑剔，是张吃鱼导演值得一观的影片。	正面	正面
演技好，幽默	正面	正面
太烂了浪费我时间金钱	负面	负面
剧情还凑合吧，男一号有点渣	正面	正面
剧情有些笑不出 可能跟和一起去看的人有关吧	正面	正面
都说是喜剧片，但我还没开始笑就一直哭到了结尾	正面	正面
非常不错！！！	正面	正面
强烈推荐！！	正面	正面
说实话、剧情一般般、搞笑一般般、影费不一般	负面	负面
从剧情来说还可以 从科幻来说 我认为这脱离了科幻的范畴，有点属于玄幻了	正面	正面
先笑后感动的流泪挺好看的	正面	正面
这个电影的含腾量注定他不平凡	正面	正面
真心不错呀 期待出新的电影	正面	正面
含腾量99.99% 就是结局不太喜欢🥺	正面	正面
又好笑又好哭 我老婆居然没哭	正面	正面
真好看真好看	正面	正面
很一般，很一般。	负面	负面
笑里带泪，很感人，没想到结局，很意外	正面	正面
很失望 真的谢	负面	负面
就喜欢看沈腾	正面	正面
好看的一比，。	正面	正面
感觉还不错，推荐！推荐！	正面	正面
开始笑的不要不要的！结局很感人很感动！	正面	正面
非常好看，好笑又感人	正面	正面
挺好的 我是看哭了 很喜欢马丽沈腾组合	正面	正面
都挺好的，也很搞笑	正面	正面
值得一看，支持	正面	正面
好！味道不错，就是有点少，我点的是中辣，但是还是挺辣的。	正面	正面
挺好看的哦，	正面	正面
月亮不走 我得走喽 刚子咱们回地球喽 这破地儿咱再也不来喽 这浩瀚宇宙 还得是咱地球～～😂😂😂😂	正面	正面
故事好，笑点多，特效棒，音乐佳。 旁边的女孩跟男友说：我刚要哭，又给我整笑了！ 后面的小朋友一直在笑：袋鼠好厉害！ 好的喜剧就是让人爆笑又含泪，#独行月球做到了  含腾量超级100%，就是不一样！ 全场观众都在笑，开头实在太逗了！ 袋鼠爬犁飞起的那一刻，所有人都被感动了！	正面	正面
很搞笑，好看。最后真的被浪漫到啦	正面	正面
剧情一般，不过终于轮到中国人拯救地球了。哈哈	正面	正面
好评！值得推荐！	正面	正面
剧情一般吧，好多包袱感觉都能知道下一步是什么！看完就感觉很一般！	负面	负面
好看，加油，喜欢	正面	正面
😂 笑点  独孤月跟金刚鼠斗智斗勇那一段真的笑死我了  😭 哭点  爆炸的那一瞬间真的忍住不了 爆哭 如果独孤月还活着那他和马蓝星应该很幸福吧😭	正面	正面
这部电影真的很棒！特效很好！笑点都很好笑，再然后哭点也很好哭，特别是独孤月舍命救马蓝星、救地球所有人最后那里，真的哭死我了！只因在扶梯上见了她一眼，结果一见钟情，心甘情愿当一个维修工，默默陪在她身边，暗恋她八年，到最后为了救她、救所有人牺牲了自己。真的这种太好哭了呜呜呜！再来就是感谢主创人员带来一部这么好的作品，冷色调的科技再加上暖色调的喜剧，这种搭配真的很不错！提醒一句，影片的最后还有我们沈老师的手写字！“宇宙这么大，我们还会遇见”！写的很好看哦！夸夸我们的沈老师和马老师！演技这肯定不用说了，百分百在线好嘛！造型真的惊到我了！怎么能都这么好看！还有马蓝星身上的那种清冷，独孤月身上的那种温暖，真的很能打动我！隔着绿幕都能知道对方会怎么演，默契真的很高好嘛！爱死沈马组合了！沈马最牛！本世纪最默契的搭档！ 其他老师的演技也很棒！没有比较的意思！ 祝《独行月球》票房大卖！	正面	正面
不愧是腾叔的演的，真的太好看了！电影院的笑声此起彼伏，最后也特别感人！很多帧画面非常的壮观！推荐大家去看！	正面	正面
挺好看的，好多搞笑片段	正面	正面
一般般...	负面	负面
看的IMAX场👀沈腾还是稳，自带笑点，袋鼠🦘刚子也超憨厚的，剧情起起伏伏，有哭有笑，结局不像欧美大片那样大团圆结局，感觉挺好的，特效方面稳稳的，希望国产科幻越做越好吧！😂😂😂😂😂	正面	正面
正义感，搞笑，团结，针不戳	正面	正面
很好看，麻花出品，必是精品	正面	正面
首先要赞的是特效真的很震撼，其次含腾量超高的影片就不必担心搞笑程度了，大家都再夸的沈腾影帝级演技名副其实，表演的共情能力极强稳稳拿捏了观众的情绪啊！！总得来说值得票价！	正面	正面
都很好，有震撼力！	正面	正面
和家人朋友一起去看的话是一部不错的合家欢电影吧，喜剧元素一如既往的风格，不过特效做的真的是很好	正面	正面
有的点还是很感人的，画面效果很good,感情很到位。	负面	正面
前半段很搞笑。后半段吧！咋说呢。有点煽情。属于不是自然的煽情那种。	正面	正面
剧情不错，继续加油	正面	正面
很好的超级喜欢	正面	正面
好看，哭了哈哈哈，偷偷抹眼泪	正面	正面
前期搞笑后期感动	正面	正面
剧情很高，然后特效很牛耶，加油	正面	正面
期待过高了！	负面	负面
为嘛要写评论呢 凑字数吧	正面	正面
沈腾很逗，剧情有些雷同，比较搞笑	正面	正面
非常好看！推荐	正面	正面
一般般吧  感觉有点强行找泪点  跟前几部电影比有点差强人意	负面	负面
有笑点，但还没到达能笑到岔气的程度。	正面	正面
类似于流浪地球的喜剧版，电影的完成度较高，适合不带脑子看的放松电影。	正面	正面
哭死了，非常好看，一下子就抓住心理了	正面	正面
挺好看的儿子看的哭了	正面	正面
一般。要不是为了主演我都不看。这也太无聊了	负面	负面
很不错，剧情泪点和搞笑部分交错，是我看过科幻里面比较出色的	正面	正面
纯沈腾个人秀，没有精彩的对手戏，也不搞笑，有些无聊	负面	负面
值得一看，前半部笑死，后半部哭死。沈腾往那一站，就很想笑。认真起来也跟帅	正面	正面
本以为高高兴兴来看一部喜剧片的，结果扎实的感动了一把，看着看着觉得那些导演特别设下的喜剧包袱显得比较多余。演员一直在线，剧情还行，结果有点可惜，总之，我将其定义为一部有温情内核、科幻外表的非喜剧片！	正面	正面
袋鼠刚子真的很搞笑	正面	正面
沈马组合笑语连天   但就是结尾让人有点忧伤	正面	正面
宇宙那么大我们还会再遇见	正面	正面
好看特别好看特别搞笑哈哈哈	正面	正面
扣一分 怕他们骄傲	正面	正面
一塌糊涂，太让我失望了，今年看的第一个最烂的啥玩意，大失所望！	负面	负面
剧情很好，有笑有泪	正面	正面
剧情真的很一般，不推荐看	负面	负面
挺好看的，不错。	正面	正面
真不知道哪来🉐️评分	负面	负面
非常好看的一部电影，部分催泪，部分搞笑	正面	正面
剧情不错沈腾自带笑点	正面	正面
好看的一部电影	正面	正面
沈腾的电影是值得看的，在搞笑方面喜剧方面，电影的整体会有笑点跟泪点，跟袋鼠的想处到回家到牺牲，全程高速，独孤月在月球玩滑板时，不小心把袋鼠在月球的一小步蹭掉了细节点，他与金刚袋鼠的相处模式，对马蓝星的单相思。看得很上瘾，全程很多笑点，但是这个笑的性质又是多种多样的，但能让人笑就不失为一部好的喜剧电影，还有点浪漫，每个人心中都有一处属于他的白月光，马蓝星就是独孤月的朱砂痣。	正面	正面
还可以，国产电影有进步。	正面	正面
刚子我的好兄弟	正面	正面
剧情还是很好的，笑点也很多	正面	正面
一般般还有想象的好看！	负面	正面
😭太顶了 反转好多 最后看泪目了 沈腾马丽顶级浪漫😭开心麻花yyds😭	正面	正面
很哈看。非常好	正面	正面
对于一个普通人的我来说，电影很好看的，还是值得一看，就不知道那些打一两分人是怎么想的，属实是要求太高了，	正面	正面
好看好看，含腾量极高	正面	正面
剧情搞笑而结局令人感动，特效帅炸了。如果国产电影都能达到这种特效水平谁还在乎美国电影	正面	正面
带孩子和好闺蜜一起看的，特别有意义，特别棒。	正面	正面
一直很期待沈马组合，之前夏洛特烦恼就看了十多遍，很喜欢。这部电影也真的很好看，沈腾老师对人物的演绎、对马蓝星的真情实感。影片的拍摄绝对的大制作，身临其境的体验。搞笑的情节，让我一直捂嘴笑，生怕影响其他人，但仔细一听周围其他人也和我一样。朋友还开玩笑的说让我控制一下，但真的不行，太搞笑了。	正面	正面
画面不错，剧情老套，老梗，尬笑！	负面	负面
很不错！沈马组合绝绝子！	正面	正面
挺好看，科幻、喜剧、灾难片，演技杠杠滴	正面	正面
还不错哦。。	正面	正面
特效不错 立意不错 沈腾演技不错 但笑点一般…泪点也比较俗套…总体来说一般	负面	正面
编剧出来挨打	负面	正面
笑点一般，基本到中间就可以知道结尾了，中规中矩的电影	正面	正面
很好看，不错不错的！	正面	正面
看睡着了😃 😃	负面	负面
有沈腾和马丽必须搞笑哈哈哈哈哈哈哈哈哈哈哈 真的很好看！！！亿颗星推荐！！！！	正面	正面
真的很好看，BGM也很好听，现在就在听着歌曲评论，强烈推荐	正面	正面
超级好看， 推荐	正面	正面
超级超级好看	正面	正面
有笑点有泪点，那只大袋鼠真逼真！！	正面	正面
特效杠杠的!	正面	正面
看着挺好，推荐	正面	正面
好看、特别好看	正面	正面
不错！很搞笑	正面	正面
很好看，这类题材很少见	正面	正面
一般般！笑中带泪！	正面	正面
好看得很。比流浪地球好看	正面	正面
买错电影院了，竟然不能退票	负面	负面
说实话挺不讲实际的，而且如果和漫画有很大出入应该说出，到了才发现是很大出入的我是漫画党emmm就不是很开心的，而且就有点离谱一些地方(=ｘェｘ=)	负面	负面
好看有趣值得看	正面	正面
宇宙那么大，我们总会遇见。	正面	正面
很好👍孩子很喜欢	正面	正面
嗯，慌慌张张，匆匆忙忙还是卡点到了。第一次在电影院看我韬的电影，虽然镜头很少，但我有珍惜每一秒。电影内容也很好，笑点不断，嗯呐！	正面	正面
太棒了吧，搞笑和感动并重	正面	正面
好笑又感人！	正面	正面
剧情相当可以	正面	正面
相比其他挂着沈腾主演或客串的烂片，本片“含腾量”100%诚意满满。 开心麻花自《夏洛特烦恼》之后的片子，可以说是越来越差，尤其是常远主演的，真的口碑差的离谱。但这次不一样，一部好电影该有的元素，《独行月球》都占了。 搞笑，刺激，场面，特效，动作，催泪，感动，温馨。我觉得该有的都有了。 抛开科幻和宇宙这两大主题，不用去分析这个那个的，这部片子就是一部值得看的，拯救暑期档的好片！	正面	正面
挺搞笑的……	正面	正面
挺好玩的悲剧	正面	正面
别人都在笑，不知道有什么好笑的，笑的人，笑点得有多低，全程一个笑点没有，不知道有什么好看的，简直浪费时间！	负面	负面
绝了！真好看！沈腾yyds	正面	正面
还好吧，可以的	正面	正面
特别好看，快去看呀！	正面	正面
挺好的喜剧电影，如果说不足的话，那就是设定有点离谱，宇宙知识这方面脑洞太大，很多不科学的	正面	正面
又哭又笑，好看	正面	正面
强行搞笑，为了沈腾马丽来的。那袋鼠咋就莫名其妙通人气了呢？你给我解释解释？艾玛，早都放弃国产影视了。这…彻底放弃！我要说我欧美电影的粉吧，以前怕喷，不过我现在不怕了，谁喷都行，这个电影给逼得！	负面	负面
流水的男主角，铁打的马丽，哈哈，不愧是沈腾	正面	正面
已经来过好多次啦，个人觉得还是很划算的，提前买好券更值了	正面	正面
这个电影很好看！	正面	正面
很好看，但是我真的懒得打字哈哈哈哈	正面	正面
可以 很好看	正面	正面
好很好看！！	正面	正面
电影非常好看，	正面	正面
剧情挺流畅的，也人性的生活，就是有些小细节没处理好，像观看一排的小座椅太像电影院了，不像避难所，搞笑感人还是喜欢的	正面	正面
太好看了(｡･ω･｡)ﾉ♡，喜欢沈马组合的电影	正面	正面
好 真好 太好了	正面	正面
还可以吧嗯嗯	正面	正面
不错值得观看	正面	正面
好看，沈腾很搞笑，孩子们都喜欢，最后那奉献精神很有教育义意，值得与年轻人分享。	正面	正面
喜剧的内核都是悲剧	正面	正面
好看，好笑，感动，果然还得是腾哥👍👍👍	正面	正面
虽然搞笑，但是很值得反思啊。	正面	正面
好看死了，太喜欢沈腾了	正面	正面
好看感人，特效也好	正面	正面
还好吧，符合开心麻花的特点。刻意逗笑，但是又不会让人觉得烦。还不错。值得推荐	正面	正面
前面让你笑死，后面让你哭死，但是真的太好看了	正面	正面
被高评分骗去看的，沈腾和马丽以后不要拍这种烂片了，败好感	负面	负面
超爱神马组合，又笑又哭，有机会再去看一次	正面	正面
没什么意思，因为有沈腾才去看，拍的一般	正面	负面
真的很好的一部电影，笑中带泪，在欢笑之余深受感动	正面	正面
作为喜剧，较为一般	负面	正面
超級好看，挺搞笑的	正面	正面
挺好的，非常不错	正面	正面
笑中有泪，不错！	正面	正面
挺好的剧情。	正面	正面
好看，环境很好	正面	正面
强行煽情，没啥可说的	负面	负面
🌟 推荐，一百个人有一百条不同的看法，说的再多都不如自己去看，不能听别人说，一定要自己看	正面	正面
沈腾还是只适合演喜剧片，这种带科幻的喜剧反正我是看了睡着了。	负面	负面
灾难片演成了喜剧片，感觉味道怪怪的	正面	正面
嗯嗯挺好的知道了	正面	正面
不搞笑 除了沈腾牺牲的那感人 真的不好看	负面	负面
几个什么关系没化妆没关系吗关系搭嘎	负面	正面
沈腾的演技在这部剧里有了很大的展现。喜剧的内核是悲剧，用宇宙月球地球的庞大概念述说一个关于家和爱的主题，很成功的电影。张吃鱼的剧本是真可以。有喜有悲又笑又哭	正面	正面
含腾量特别高，超级喜欢	正面	正面
在生活中，总有这样一种人，普普通通是他们的人设，碌碌无为是他们的日常，但在关键时刻总能挺身而出，逆光而行	正面	正面
既搞笑又煽情	正面	正面
很戳笑点哈哈	正面	正面
好看👍推荐	正面	正面
棒非常的支持	正面	正面
退钱 什么开心麻花	负面	负面
非常好看哟西	正面	正面
还不错，挺好看的	正面	正面
🌅 画面 流浪地球给的画面感还是顶级棒的，	正面	正面
很好看 特别棒	正面	正面
很好看，棒棒哒	正面	正面
对于以前的作品，这部不咋滴	负面	负面
沈腾演的真棒！好看的电影	正面	正面
好看 有笑点有泪点 如果说缺点 唯一的缺点就是结局像流浪的地球🌍 要是圆满结局就好了 唯一的遗憾吧	正面	正面
#沈马CP#笑点与眼泪齐飞！💜	正面	正面
蛮好看的，好久没看见这么喜欢的剧了	正面	正面
沈腾挺搞笑的	正面	正面
有点尬，笑点紧跟网络热点，强制感动泪点，比较不值得花钱看。	负面	负面
好看哇呀呀呀	正面	正面
很专业，很壮美，轻喜剧！	正面	正面
真的挺不错的，每个人眼里都有自己的马蓝星	正面	正面
马丽还是适合和沈腾搭档，沈腾自带搞笑成份	正面	正面
很一般，俗套的笑点，没有逻辑的剧情硬要套英雄主义	负面	负面
综合还可以，时间一久就没啥印象了	正面	正面
真的很好看，开心麻花的这个本子接的是真的好，前半段很搞笑后半段很感动，永远喜欢沈马组合	正面	正面
很好看啊啊啊啊啊 第二遍啦🚀 笑点很多	正面	正面
剧情好看，画面感好，演技好	正面	正面
一般般，可能是我期待太高了吧	负面	负面
剧情真的差 马丽演技不错	负面	负面
非常好看家人们	正面	正面
还可以！！	正面	正面
还行 挺好看 但没评论的这么有意思	正面	正面
演技在线，虽然梗有点老，胜在腾哥可以驾驭	正面	正面
太好看了，有沈腾就好看。笑一笑十年少，不喜欢伤感的，不剧透了，大家自己去看吧！	正面	正面
还不错，前期很搞笑	正面	正面
非常不错，特别好看	正面	正面
疫情当下，实属不易呀！冲啊	正面	正面
真烂，演小品吧，还是小品好看点	负面	负面
孩子说挺好看	正面	正面
很高兴，也很感动	正面	正面
🌟 推荐 超搞笑 很科幻	正面	正面
好看，大人小孩都可以，都喜欢	正面	正面
很不错，带孩子看的，无尿点，孩子憋坏了	正面	正面
可以，没有那种主角无敌，搞笑感人都恰到好处	正面	正面
还行！！！！	正面	正面
不是特别搞笑	正面	负面
😭 哭点 真的很不错 最后那句 马蓝星 带我回家真的很感动	正面	正面
感人 好看  刚子没有你我可怎么活啊	正面	正面
特别好看 搞笑	正面	正面
笑点数不过来	正面	正面
很好，觉得不错	正面	正面
确实不赖  前面好笑 后面哭死	正面	正面
很好笑 。。。	正面	正面
剧情穿插流畅，演员演技在线	正面	正面
古校长很棒！！！	正面	正面
真的很好看  全程无尿点  就是感觉抖音预告的太多了  不应该告诉大家有只袋鼠   袋鼠出场前营造的氛围一点没看进去 。不过全程一直在笑   全场也都都是没停过笑声，结局升华了  感人了	正面	正面
前面笑的我合不拢嘴 真是沈腾出场 必是精品	正面	正面
好看。。。。赞	正面	正面
非常好看！极力推荐！ 搞笑、反转、感动、共情！ 看到最后突然出现一句话 沈腾终于又让马丽成为了他电影中的女主角！	正面	正面
挺好的 可以	正面	正面
整部电影除了科幻感值得一提以外，其他乏善可陈。首先拿这么严谨的高科技来搞笑就很搞笑，故事的情节设计完全是按照小品的节奏来的，还有台词简直跟小品，最后那种人类伟大光辉的塑造，感觉来的太突然，感觉也像现在的娱乐小品，搞笑了整个晚上，结尾突然煽了这么大个情，没有感动和震撼，只觉得编剧的能力实在一般。还有金刚鼠，太伪科学了…不知道9.3的影评从何而来？	负面	负面
小品式电影吧，一会儿抛个包袱，笑笑就完了，没有太深刻的意义。喜剧效果还行。	正面	负面
好看，还行，	正面	正面
🌟 推荐5  😊 演技5  🌅 画面4  🎉闪光点5 结尾有点害	正面	正面
好看，爆笑。后来剧情感动的我都流泪了，必看款	正面	正面
挺搞笑也挺感动的，最后一段看哭了，那种牺牲自己的大无畏精神值得我们学习	正面	正面
很好看 笑泪并存	正面	正面
画面感十足，特效也不假，值得推荐，主要原因还是喜剧演员	正面	正面
我觉得就还好啦	负面	正面
不愧是沈马，不愧是开心麻花。个人观点，仅供参考。真的很好看！	正面	正面
前面很搞笑😂，后面很感人😉	正面	正面
还是沈腾演的那种轻松慢热的喜剧节奏，不过没想到后面是悲剧，不过和他以往的作品比，也只是中规中矩🤗	正面	正面
很好！笑中带泪！	正面	正面
好，非常好，越来越好。	正面	正面
还行，票价值了，很喜欢	正面	正面
看了，又好像没看，因为 不记得看了啥	正面	正面
🌟 推荐值票价  😂 笑点频繁  🌅 画面精美  😊 演技在线  🎉闪光点袋鼠yyds	正面	正面
很好看，记得带上孩子们。	正面	正面
有笑点有泪点。	正面	正面
比预想的好看，本来以为多为一个人的镜头会很慢节奏，有点单调，结果情节和节奏不错，也没故意煽情，挺不错的，就是里面的胖妞辣目洋子很多余，没她更好	正面	正面
很好，古天乐，刘青云yyds	正面	正面
挺不错的，快看	正面	正面
还不错，杀破狼2挺搞笑	正面	正面
很好👌！优惠多多	正面	正面
不错，感动，泪目	正面	正面
剧情不错，赞	正面	正面
是很浪漫，里面马蓝星提到了月球上的一个环形山——“万户山”，正好在玩#江南百景图，里面有个人物叫“万户”，玩的时候没有好好研究他，现在知道了，他是全世界航天第一人啊！🤩	正面	正面
这么烂的片子…刷到9.6能骗多少观众？大家都会口口相传的	负面	负面
常远、马丽演技太糟烂，拉低沈腾水平。	负面	负面
中国人独有的浪漫💕 🌏	正面	正面
算是这两年最好看的了，没有羞羞的铁拳笑点多，比李茶的姑妈强多了。值得看	正面	正面
🌟 推荐  😂 笑点，小心皱纹，爆笑， 一个因为“爱情”的英雄拯救地球	正面	正面
棒极了，喜欢	正面	正面
挺好啊人呢门口扣扣空间	正面	正面
垃圾无聊强行搞笑尴尬	负面	负面
还不错，蛮好看的	正面	正面
太好看了，沈腾马丽戏份十足	正面	正面
究竟是剧荒到什么程度大家才会觉得它还可以看？	负面	正面
Deadly romantic	正面	负面
一进门真的是惊艳到了，环境特别不错，是周围环境最好的了，性价比非常高	正面	正面
hi to be a great day	正面	正面
挺不错得，敢于牺牲小我，完成大我的精神值得一看	正面	正面
好看，相当不错的电影	正面	正面
喜欢沈腾演的	正面	正面
还行吧，前面比较搞笑	正面	正面
开心麻花，值得期待，喜欢那个袋鼠，喜欢那个姿势，喜欢那个歌曲，总是令人开怀大笑！	正面	正面
太好，最后看的感动	正面	正面
进去睡了一觉	负面	负面
腾哥和马丽还是不错的！	正面	正面
搞笑片 ….	正面	正面
不错👍👍	正面	正面
超赞，刚子我的最爱，沈腾马丽演技超赞，反正值得去看，对了还有你们爱的黄子韬也在虽然演了个油腻大叔！	正面	正面
挺好看的，笑点很多	正面	正面
好看的不要，不要的。。。	正面	正面
喜剧妥妥的 剧情激烈跌宕起伏 超级赞 就是结局有些意难平 但却是最伟大最完美的结局	正面	正面
一般 喜剧不算传统意义的喜剧 科幻也不算科幻 说感人么也没太感人 配乐还不错	正面	正面
感觉是为了搞笑而搞笑，没得内容，适合小朋友看，不晓得9.3分是怎么来的	负面	负面
可以的可以的	正面	正面
爱看的怎么都爱看 不爱看的看啥都难看 刷两遍	正面	负面
挺好看的，特别逗，含腾量也挺高的，就是吧能不能不 把我腾哥写死了，整得怪伤心的	正面	正面
好看好玩，沈腾的电影不会让人失望！	正面	正面
解闷看看挺好的，被各种营销号把期望搞太高了。所以没有她们说的那么好。但是应该预订了年度第二了。我心中的年度第一还是人生大事。有机会去看看吧，挺好的。	正面	正面
前面搞笑后面感动～喜欢～	正面	正面
只能说一般般	负面	负面
还得是沈腾啊😂	正面	正面
一般般搞笑吧 特效还可以	正面	正面
可能期待值太高了 有点失望 不怎么好看	负面	负面
电影很好看，笑点很密集，就是最后结局给我冲没了，喜头悲尾呗就是。	正面	正面
很好看，特别搞笑，值得推荐	正面	正面
前面大半段作为喜剧挺好看，最后塑造英雄形象拍的太刻意了反而少了共鸣。总的不错	正面	正面
特别好，值得看	正面	正面
真的有点失望	负面	负面
很值得二刷的电影	正面	正面
呼，哦是因为，醒一下	正面	正面
诚意有，但未必有宣传那么棒，算是能看。	正面	正面
不看也不会后悔 看了也就看了的影片	负面	正面
非常棒，，，	正面	正面
开心麻花的一次新突破，还是不错的。一贯的搞笑，还有核心思想	正面	正面
搞笑 ai q	正面	正面
好 不错喔好	正面	正面
好看，就是结局太好哭了😭	正面	正面
真的很棒，值得一看！	正面	正面
好看，剧情搞笑	正面	正面
剧情不错，演员演技在线，画面非常细腻好看，笑点泪点十足，强烈推荐！另外瑕疵部分的话，就是直播的一些漏洞，有几处稍有牵强，还有就是配乐，还行，但是主旋律配乐没有唱进心里，感觉要是把请带着浪漫远航这首歌放进来更好了，当然，歌词不太搭了就。。。	正面	正面
垃圾。偷票房	负面	负面
这次的开心麻花，绝对能让喜欢他们作品的观众，心满意足的走出影院。 沈腾和马丽时隔七年再次合作长片，不得不说，好的搭档即便不用面对面，也可以演出火花四溅。  不过在「独行月球」里，比沈马组合还让我上头的，竟然是沈叔叔和一只与他相爱相杀的袋鼠。 这一人一袋鼠在我看来，不仅是银幕年度最搞笑组合，还是今年到目前为止让我最为感动的一对CP。 是的，「独行月球」不但很好笑，竟然还有点好哭，这是我在看过之前完全没有想到的。  除了两位主角和一位主鼠外，「独行月球」也继承了开心麻花过去成功作品的一贯传统，那就是配角出彩。 “多喝烫水”的常远，依旧严肃却被喜剧解构的李成儒，跪族灵魂歌者黄才伦等等都很有戏。  但在一众配角中最令我意外的，是黄子韬。 他以完全不顾形象的自黑式表演，去诠释了一个世界末日背景下的爱豆。 而扮演黄子韬经纪人的王成思，还是那样自带喜感，每一句台词都戳我笑点。  搞笑之外，「独行月球」还融入了一些颇具现实意义的辛辣讽刺，相当犀利让人过瘾，影片在这方面也很值得被展开讨论，这里就不过多剧透了，大家还是去影院自行感受	正面	正面
太好看了啊啊	正面	正面
笑点感觉很低……不知道有没有同感的🤷‍♂️	负面	负面
还是可以的，我很喜欢😊	正面	正面
挺好看，挺不错的	正面	正面
很搞笑，演技不错，好评	正面	正面
挺搞笑，也能感受到只有自己的孤独，还有后来的崛起，很感动，有笑有泪	正面	正面
离地铁站很近，而且店里环境非常合我的口味，迅速赶来给个	正面	正面
剧情真的是拉胯至极，搞不清楚烂片为啥会有这么高的分，真的服	负面	负面
好看 总是热泪盈眶 腾叔第二部要回来呀	正面	正面
超级烂片  送好评的人四个字  神马玩意	负面	负面
很好看呢哈哈，干净又卫生，味道还特别好，特别适合好朋友一起去吃饭聊天商家十分热情，强烈推荐，以后会常来的	正面	正面
剧情台词逻辑在线有笑有泪。画面特效都很到位。 虽然大场面不多。但绝对算是现阶段最好的中国科幻电影之一	正面	正面
好看都去看吧	正面	正面
还行吧，孩子喜欢	负面	正面
挺好看的！含腾量挺高！	正面	正面
好看，就是门票好贵，41一个人，如果是3D效果的更好啦	正面	正面
剧情很不错，沈腾的幽默风趣，感人画面也不错，袋鼠🦘的表演真是太用心了	正面	正面
陪孩子看。孩子很喜欢	正面	正面
推荐去看看袋鼠🦘	正面	正面
剧情很好演技不错	正面	正面
很好，笑点超多	正面	正面
太赞了，又搞笑又感人	正面	正面
非常不错赞赞赞赞赞	正面	正面
“可能刚子有它自己的想法”，哈哈哈，太笑了😂	负面	正面
好好看 前面很搞笑 后面很感人 沈腾演技太好了 黄子韬承包了我的笑点哈哈哈	正面	正面
还不错   可以看看	正面	正面
后面很感人前面很搞笑	正面	正面
含腾量100%结尾很感人	正面	正面
电影不错，不过还是不太喜欢一开始喜剧后期感人的影片，不过还挺好的	正面	正面
笑点可以，剧情有点太扯了吧！	正面	正面
好看好看  很好笑也很正能量   但有些长了  不过总体来说挺好看	正面	正面
我笑不出来，我笑死了	正面	正面
好看，搞笑又让人感动	正面	正面
含腾量可以的一部电影  有惊险 有感动	正面	正面
挺不错的，也有很多梗，和对象一起去看的，蛮搞笑的	正面	正面
沈马的一如既往的不错	正面	正面
还是挺适合一家人看的	正面	正面
没有西虹市和夏洛特好看	负面	负面
超级爆笑，又感人哭的稀里哗啦。沈腾出品必出精品呀真是。满分满分全程高能	正面	正面
画面演技都特别好，好喜欢沈腾马丽。	正面	正面
挺好看的又哭又笑	正面	正面
十分喜欢他们几个主演的电影	正面	正面
挺好，不错的电影！	正面	正面
一般吧，大型科幻爱情喜剧吧，四不像的感觉吧，乐呵乐呵就行，挣快钱呗	负面	正面
一般吧。。，	负面	负面
绝了，支持沈腾，永远爱你	正面	正面
真的很不错👍	正面	正面
已经算开心麻花近年来无数如出一辙喜剧里比较有创新的了，题材还是有创意的	负面	正面
世界上有这样一种人，他们普普通通，但总能在关键时刻逆向而行。 很不错的一部电影，值得观看。	正面	正面
电影很好看  又有笑点又有眼泪	正面	正面
这个影院**！！不舍得开冷风，影院又闷又味，，，特别难受。这个电影还可以，但是不及夏洛特烦恼也不如羞羞拳。但是时隔这么多年，再次合体也不容易。还是有很多笑点的。	正面	负面
沈腾和马丽绝对放心	正面	正面
一部很棒的电影，喜乐又带情感，值得多刷几次	正面	正面
剧情很一般，剧情有点尬，笑点跟之前比起来差太多，剧情有点跟流浪地球有些相似	负面	负面
我觉得挺好的，我家四岁的孩子也看的起劲，推荐	正面	正面
尽管还是有不少缺点，但是作为中国影视上比较少见的科幻+喜剧，还是要给点赞的，影片有不少亮点，值得一看！	正面	正面
能让人笑岔气儿，也能让人眼含泪花。情节紧凑，制作细节超越欧美大。唯一不足就是独孤月在月球上活动，月球重力影响的镜头细节不完美，还有就是太空出仓不带安全锁😓 。不过，丝毫不影响观赏。总之，非常值得推荐的电影。可以和《流浪地球》媲美，甚至更超越。👍	正面	正面
感觉挺好，有搞笑，有感动，有大爱，有小爱...	正面	正面
孩子看的说是喜剧之片	正面	正面
好笑又催泪，演技很好	正面	正面
好看，笑着笑着就哭了，	正面	正面
电影可以就是观看的人不行，没素质，都在看电影，自己那个手机大喊大叫的打电话打扰大家观看	正面	正面
很不错的题材，把希望寓意其中	正面	正面
好看好看！喜欢沈腾马丽的千万别错过！ 已经准备二刷了。	正面	正面
好看 很感动	正面	正面
结局不美丽，也许现在流行这种Ｂ结尾吧……	正面	正面
还是开心麻花一贯的风格，可能是看多了他们的作品，基本上能猜到接下来会发生什么，没太多惊喜，但是整个故事还算好。	正面	正面
好，特别好看	正面	正面
好看。剧情上致敬了 火星救援+流浪地球，但是梗玩得很不错，有笑有泪。一些不合逻辑的地方，对于一部搞笑片来说，无所谓了	正面	正面
又感人，又好看	正面	正面
剧情一如既往的搞笑，画面感一看就不是5毛钱的特效！值得推荐！	正面	正面
挺不错的，特别是有些插曲 好搞笑	正面	正面
很好看，环境很好	正面	正面
电影超棒，笑得我腮帮子直疼，有喜有悲，喜的时候是真喜，悲的时候也真是大义，很好的一部影片，值得观看，里边人物有血有肉，演员演技也非常好，有沈腾马丽的电影绝对差不了，笑点频频，金句频出，这部电影将会是又一部影坛巨作，(｡･ω･｡)ﾉ♡😎😎	正面	正面
不错，沈腾马丽依然很棒	正面	正面
什么电影，够垃	负面	负面
还将就看得	正面	正面
🎉闪光点 嗯😁 ！剧情一个扣一个。现实跟电影一样，没有完美的结局！	正面	正面
很好看，独孤月和刚子相互陪伴	正面	正面
非常有意思的	正面	正面
非常棒！！！	正面	正面
不在我的笑点上，但是也还行	正面	正面
笑点密集，非常不错	正面	正面
也还行比预期差点儿	正面	正面
挺一般的爆米花片	正面	负面
好看 原本以为是纯喜剧 但是大有深意	正面	正面
好看，特别的好看	正面	正面
不好看😔 情节老套庸俗！ 夏洛特的烦恼好看。不要演这种类型体彩的电影了。	负面	负面
又哭又笑得，最后沈腾没有戴太空帽，说明他已经牺牲了	正面	正面
还不错 好看	正面	正面
很好看，强力推荐	正面	正面
不错，搞笑，欢快	正面	正面
很不错哦，值得看	正面	正面
看得出来，沈腾和马丽在奖一个普通的台本演的好看些	正面	正面
太好笑了看完太好笑了，看完一场没笑，断气挺不错的	正面	正面
剧情设计很独特，这种科幻喜剧开心麻花说实话做的不错 。 有人说电影前面笑点硬凹，但是说实话作为沈马这么多年的观众，或许某句台词别的演员说出来就不好笑，但是沈腾马丽说的话就很戳笑点。这也正是他们能成为喜剧搭档top 1的原因之一，这就是他们最大的卖点。 还有人说电影后面刻意煽情，这个真的建议因为这种评价被劝退的朋友去看一看到底是不是刻意煽情，只能说我站在一个观影多年的大学生的角度，电影设置的所谓煽情情节很自然也很合理，电影最后的设计很浪漫也很感动，泪点低的人会哭的情节，怎么算“刻意煽情”？ 最后一句，百花奖沈腾0票是我今年听过的最大的笑话。	正面	正面
剧情很有趣，也很有格局，真的很好看！！演技也超棒！爱了爱了 🌟 推荐！！	正面	正面
超级无敌爆炸	正面	正面
悲喜交加 普普通通	正面	正面
开心开心！！	正面	正面
沈马组合就是yyds	正面	正面
非常值得观看的电影。	正面	正面
好看的，开心麻花棒棒哒	正面	正面
独行月球真的很好看，沈腾的演技真的棒，到最好的那一句带我回家真的泪目了！！！电影中的情节也是很有趣，沈腾跟一只金刚袋鼠在月球！这也是本剧的笑点“刚子”和沈腾相爱相杀。前半程搞笑情节很多，中程到后半场，让人的感觉是紧张又激动，知道结尾的泪目！	正面	正面
很好看，很感动，也很喜欢沈腾！	正面	正面
太好看了，已经好久没有看到这么好看的电影了，搞笑中带着浪漫，浪漫中带着感动，开心麻花出品，不得撇。真的太好看了！！强烈推荐！！	正面	正面
不错，结局也不老套	正面	正面
袋鼠特效真的做的很好，两位老师的演技也很棒！	正面	正面
还不错，挺好的，开心麻花还是有笑点的。	正面	正面
好，特别特别好吃	正面	正面
前面多搞笑 后面多感人	正面	正面
好看，电影精彩	正面	正面
非常棒！！！！	正面	正面
挺好的特别好看	正面	正面
不错.值得一看	正面	正面
挺一般的，笑点高的人不建议看，和原来的作品比差很对	负面	负面
很值得，经常会在我快感动的时候搞笑起来，真的会笑哈哈哈	正面	正面
电影真的超级好看！！！沈腾的电影从来不会让人失望，泪点笑点交织，真的超级好看！！！	正面	正面
一般吧，看的时候也没几个人	负面	负面
还不错笑点很多	正面	正面
搞笑担当！！	正面	正面
太棒了，非常非常推荐	正面	正面
沈腾出品，必是精品。	正面	正面
很好看，非常推荐	正面	正面
还行，值得去看	正面	正面
好看 很好笑	正面	正面
还可以 还不错	正面	正面
好看，感人，我和儿子都喜欢。	正面	正面
拍的很好 很喜欢看	正面	正面
笑点不太多，有点像流浪地球的感觉	正面	负面
搞笑，笑点好多，尤其是大袋鼠，超爱，	正面	正面
狗肉夫君君娃娃鱼偶偶偶	正面	正面
挺有创意的！	正面	正面
语音王  五来PK破98989天哦了也看实物我来送咯0他	正面	正面
支持国产电影	正面	正面
又搞笑又感动！	正面	正面
真的是又好哭又好笑，这么大的宇宙我们还有机会遇见，爱了爱了，值得推荐，好好看	正面	正面
真的太棒了！！！国产科幻做的越来越好了！又哭又笑还得是开心麻花！！！沈叔叔长头发好帅！！马丽姐姐黑发好米！！这票价真值！！！都给我去看！！这种电影活该大卖😍😍😍😍	正面	正面
含腾量杠杠的👍🏻👍🏻，笑点很多	正面	正面
袋鼠棒棒哒  结局不愿意面对	正面	正面
很棒，推荐。	正面	正面
好电影很好看	正面	正面
好的很！！！	正面	正面
还行 年纪越大笑点越高 听到country road老让我想起异形契约😂	正面	正面
be的喜剧，前期好笑后期好哭。很喜欢独孤月和地球上人们的互相拯救，独孤月带给人们希望，让人们在阴暗的地下重见光芒，而人们也将绝望中的独孤月拉了出来。以点带面用一个人的故事概括人类的伟大征程，真的很不错。尽管网上争议很大还是值得一看	正面	正面
好看，剧情感人	正面	正面
真的垃圾，最烂之一	负面	负面
笑一笑，乐一乐，一下午就过去了。	正面	正面
挺好看的。不错	正面	正面
可以。整得好。	正面	正面
剧情真的很有意思，	正面	正面
一般，没有期待的好看	正面	负面
挺好的、有笑点也有泪点、只是剧情看下来还是挺扯的、只能说当喜剧片来看	正面	正面
奥斯卡小金人	正面	正面
很感人但是搞笑元素太多没哭出来👀	正面	正面
电影不愧评价这么高，可以算是实至名归了，会推荐给朋友的	正面	正面
哭中带笑笑中带泪	正面	正面
还好吧……..	正面	正面
剧情爆米花还可以吧 袋鼠很新奇 搞笑包袱感觉没前几部多了	正面	正面
可以，估计是今年最好的喜剧片	正面	正面
非常哒好看推荐噢	正面	正面
剧情写得非常精彩，非常好看特别吧，就是我评论的有点晚。	正面	正面
还可以，虽然煽情有点牵强，但是笑点还是挺密集的	正面	正面
笑点很密集，沈腾一出来我就觉得好笑，情感也很细腻	正面	正面
很好 我觉得挺好的	正面	正面
好看，很有科幻感，也有感人的一幕。	正面	正面
没有想象中那么好 只是看到沈腾就会笑 感动的地方，也还好~ 总体没有想象那么的那么多内容~ 就一般般。。。	正面	正面
好看😊完美	正面	正面
我觉得好看的	正面	正面
前面搞笑，后面蛮感人的，孩子看得懂	正面	正面
剧情非常好，画面很棒	正面	正面
很好看 很喜欢 沈叔叔的每个电影都要去看，一如既往的好	正面	正面
演技绝了，沈腾马丽一起不会出错的，我反正哭的很惨	正面	正面
尴尬的一塌糊涂	负面	负面
不错呢  就是说教式的演绎还是多了点	正面	正面
你是真冷血，我是真喜欢。	正面	正面
好看，太好看	正面	正面
喜剧+科幻+煽情都不错	正面	正面
非常不错，很喜欢	正面	正面
剧情挺有趣的，就是感觉稍有累赘感	正面	正面
真的很好看，而且片尾的视觉做的好棒	正面	正面
以为是个喜剧 结果哭了半包纸 还想二刷	正面	正面
无语硬煽情🧄	负面	负面
不错，挺好看。	正面	正面
沈腾演的电影不错，值得看	正面	正面
电影推迟15分钟才开始，还不好看	负面	负面
居然是be 后半段真的好戳我泪点	正面	正面
很好的电影，有笑点，有温情。让人忘记烦恼，让人感动！	正面	正面
非常失望，第一次不好看的沈腾马丽的电影。没想到！	负面	负面
挺好看的 挺乐的	正面	正面
效果满分，含腾量满分，强烈推荐	正面	正面
好看的，值得一看，非常解压，几乎一直在笑…哈哈哈  😊 演技：这次玛丽演的很一本正经，挺不错的。腾叔和刚子真的太逗了  😂 笑点 滕叔，刚子，葫芦丝	正面	正面
很好看，特效和剧情都很好。前面沈腾和金刚鼠的剧情爆笑，中间沈腾以为世界上就只剩他一个人，失去了活下去的勇气，想自杀时的心酸，后面为地球牺牲自己的时候爆哭。是一部很值得去看到电影，	正面	正面
实话实说，配乐，画面都还行其他真是一言难尽，我笑点比较高，只笑了一次，而且后半段在刷手机了	负面	负面
剧情紧凑，含腾量很高，非常逗	正面	正面
还可以！值得去！	正面	正面
搞笑也确实蛮搞笑的，有一说一	正面	正面
炒鸡好看！别犹豫了姐妹，直接冲！	正面	正面
爆米花电影，还行吧	正面	正面
非常好👍👍	正面	正面
好看奔着沈腾来的	正面	正面
真的不觉得很好看，很搞笑！可能不是片子的问题，是我的问题，唉	正面	负面
棒棒的  不错不错	正面	正面
动物，日常嘤嘤嘤	正面	正面
喜剧给5分，科幻给9分，沈腾的一小步，国产科幻的一大步。这部电影有种该死的宇宙英雄浪漫，光是刚子带独孤月月球飞驰的那一段，足以值回票价了	正面	正面
笑着笑着就哭了，宇宙那么大，我们一定还会遇见。	正面	正面
明明是喜剧，却从头哭到尾！	正面	正面
比人生大事差太多了，顶多给五分！强行煽情多余！抄袭功夫熊猫（最后全民支持）和流浪地球（吴京开飞船自我牺牲）…	负面	负面
非常好看呦！	正面	正面
推荐观看，好看	正面	正面
哈哈哈哈!!	正面	正面
很好看 笑点泪点都有	正面	正面
挺好看的，有感动点有搞好的地方	正面	正面
超出预期的没那么好看 没什么新梗 有搞笑有煽情 就感觉这电影应该更好一点 沈腾➕马丽诶 这可是神仙组合了 就可能个人期待太高了 剧情有点点老套 你能猜到转折 就是给了你足够的时间让你反应过来 还有为什么有袋鼠 （不是说袋鼠不好）就是我感觉这袋鼠的作用就是用在带他飞跃峡谷 有些地方就很不适 比如说鼻血那里 我真的有点尴尬 但还是有好的地方 特效不错	负面	正面
非常的有梗和搞笑，能在每一个悲伤，突然煽情的剧情都能立马来一个笑点压住，很有梗，也非常意想不到，很难得，去电影院乐呵一下，也值得了。而且里面的一些语句和言论，都讲的很中心巴上，他也只是个普通人，平凡的人，勇气确实也震撼到我了！喜欢！大家都去给我快乐一下！	正面	正面
很好 值得看的一部电影	正面	正面
好看    沈腾的喜剧  从来都没让人失望	正面	正面
很好看，既好笑又感人，麻花从来不让人失望	正面	正面
笑中带泪，超级感人，最后升级为家国情怀，很值得看	正面	正面
真心的绝绝子	正面	正面
剧情没有想象中好看，但是确实制作还不错，场景搭建也挺好	正面	正面
还好 看一半睡着了	正面	正面
一般吧，没有太好看	负面	负面
觉得低于期待值	正面	负面
还阔以，一直相信沈腾	正面	正面
看在沈腾的面子上给个3星半吧，笑点都很尬，很多段子纯粹是为了搞笑去搞笑，没有那种水到渠成的感觉，卖惨力度过大了。整部片子搞笑没那么搞笑，科幻没那么科幻。和代表作夏洛特烦恼，西虹市首富那完全没法比。有点当初徐峥2部囧系列以后那种日暮西山的感觉。	正面	负面
剧情一般，就是有点搞笑，但是所有喜剧都一个套路开始搞笑，结尾煽情，审美疲劳了。	正面	负面
好看的。沈腾马丽	正面	正面
好的好的东西	正面	正面
挺好看的 搞笑 也感动	正面	正面
有逻辑失误，好在明星阵容强大，有喜剧谐星支撑，还行吧	正面	正面
特效不错，笑出眼泪	正面	正面
搞笑，没白去	正面	正面
看着不错，很搞笑	正面	正面
还不错，可以看	正面	正面
是是是额外的时候	正面	正面
话不多说，五星好评！你可以永远相信沈马组合❤️	正面	正面
任何一个人不去看我都会伤心的ok？！！！！	正面	正面
好很好看666	正面	正面
关于《独行月球》这部电影，喜剧型的一面体现的较少更多的励志鼓舞，并且该电影有一点喜头悲尾的局势，脱离了传统的喜头喜尾，没有了大团圆式的结尾了 📚 剧本	正面	正面
值得二刷！！	正面	正面
推荐，值得观看	正面	正面
不好笑，但是故事比较有趣吧 来看个沈腾只能这么说！给开心麻花团队买个情谊吧。	正面	正面
还可以，闲时看个电影挺好的，至于剧情内容没那么重要。	正面	正面
还挺好的不错哦	正面	正面
不戳不戳挺好看的	正面	正面
还是比较好的	正面	正面
挺好的喜剧，值得看看	正面	正面
很有意思很好	正面	正面
带儿子一起看的，真的是很感人的一部电影。	正面	正面
还阔以。没让我失望。	正面	正面
好看不错。哈哈哈哈哈	正面	正面
超级烂片，谁看谁后悔，袋鼠的演技还行	负面	负面
好看，有意义	正面	正面
还可以 🌟 推荐  🌟 推荐	正面	正面
画面不错，推荐大家去看！	正面	正面
超级爱的CP组合，沈马，真的是爱了爱了❤我会推荐给身边的朋友们	正面	正面
满意满意！！！	正面	正面
出乎意外的好看啊	正面	正面
🌅 画面 震撼	正面	正面
搞笑还有故事有情感有内涵，好好看，不愧是开心麻花，Never let anyone down。	正面	正面
不错，有搞笑，也有感动	正面	正面
孤独月球…有情人终成眷属	正面	正面
剧情还是挺有意义的，算是喜剧的一种新尝试，喜剧里又包含了许多想讲的道理，格局打开了。	正面	正面
非常精彩，值得推荐	正面	正面
不够搞笑，没意思	负面	负面
挺好的，本来看的时候在想什么时候能看一部只笑不哭的电影，后来想了想，其实泪中带笑挺好的，既不极度悲伤，也能在笑和泪中感悟电影（关于泪中带笑印象最深的就是“你不是一个人”那段，本来哭得好好的然后画风突变真给我整不会了，不知道该哭还是该笑了😂）     独行月球真的好看！！都给我看！！！认真的感悟就不写了反正真的能引起深思	正面	正面
这部剧整体感觉一般，一头一尾还可以	正面	正面
喜欢这种最后才知道的惊喜，为什么工程师去当一个维修工，八年迟来的表白	正面	正面
喜欢他们的所有电影	正面	正面
其实一般 般	负面	负面
开心麻花 值得信赖！	正面	正面
剧情很好 挺搞笑的	正面	正面
很感人很开心	正面	正面
我觉得不好看 这是我第一次觉得这电影是最不好看的	负面	负面
《独行月球》，看完了都没记对片名。 说这电影是太能胡编啦都是抬举它。就纳了闷了，这好几亿的票房是咋来的？ 有一件事情倒是可以确定：这届电影百花奖沈腾得0票是真没委屈他。	负面	负面
还行吧 幽默搞笑	正面	正面
说实话 太让人失望了 跟之前的几部比 简直是一个天上一个地下 也就跟袋鼠那几处有点笑点 其余的真心是不行 要不是奔着沈马 压根不去 越来越糊弄事了。	负面	负面
只有一个彩蛋，	正面	正面
带娃去的，开始笑，后来又被泪点莫名戳中..	正面	正面
片子不错，笑点很多，值得一看	正面	正面
搞笑，感人，	正面	正面
看了一半退场，不知道媒体为啥会推这部片子？故事情节与《火星救援》相似，但远不如《火星救援》吸引人。	负面	负面
很感动，儿子都看哭了。	正面	正面
剧情还行吧 感觉没有期待中好看	正面	正面
好看，也有笑点	正面	正面
别浪费钱了 我觉得是真的难看。另外，我几个朋友也说很尬。	负面	负面
很好看，音质很高，剧情也很不错666	正面	正面
解闷的欢乐喜剧片，如果你比较无聊和心情压抑，里面可以让你笑的开心，也有煽情流泪的场景。总之腾式的搞笑在延续。 唯一的不足就是马丽和其他演员的参与感不强，整个世界都在看沈腾和袋鼠的双簧。没有西红柿和夏洛特剧里那样有一些形象丰富的出彩配角演员。 一部优质的电影不仅需要优秀的主角演员，配角的参与也很重要。扣一分。	正面	正面
挺好看的，给人的感觉挺好的	正面	正面
好看好看，感动又搞笑	正面	正面
剧情很细，腾哥演技很好，值得一看	正面	正面
不好看 失望了	负面	负面
剧情十分精彩	正面	正面
实在是没觉得好看	负面	负面
值得推荐，值得一看.	正面	正面
好看！搞笑又感人！	正面	正面
从头到尾，我根本就没有怎么笑过	负面	负面
当你有所期待的时候往往都会差强人意，既然电影中提到了，西虹市首富、夏洛特烦恼，没有他们好看	正面	负面
好看。搞笑。	正面	正面
有喜剧成分，但是不知道为什么，感觉没有以前开心麻花的电影搞笑了，但是还是支持沈腾	正面	正面
太好看了，感动	正面	正面
有一点被感动到，但更多的是…………	负面	正面
给沈腾打call	正面	正面
有硬伤 袋鼠雪橇怎么直播 带核弹返回地球，找死啊	负面	负面
很好看不错，可以去看看	正面	正面
我只能说及格，没达到我心里的预期，有点失望。	负面	负面
很有教育意义，搞笑也很感动，结局真的不喜欢让人心里很难受😭，还以为会有逆转，结果独孤月真的牺牲了	正面	正面
还行可以的吗	正面	正面
还行吧。还可以吧。	正面	正面
还行，就是有点强行搞笑	正面	正面
他俩的感情我能懂！	正面	正面
额，就是这样	正面	正面
两分给在沈腾的面子上	负面	正面
🌟 推荐 今天工作发生了不愉快的事，很生气。然后和家里人去看了《独行月球》，真的很搞笑！心情完全好了！知道是沈腾马丽的喜剧片，没想到还是很惊喜！喜剧电影也可以很热血！	正面	正面
还好！挺好的	正面	正面
好看，不虚此行，蚍蜉撼大树，一动也不动。人类撼陨石，让你动就动。	正面	正面
还得是沈腾，还得是沈马，嘎嘎好笑，嘎嘎好哭。	正面	正面
挺搞笑的 好看的	正面	正面
好评！推荐！	正面	正面
一个人的独行也要坚持到底	正面	正面
剧情非常好，非常值得一看	正面	正面
真的非常非常不错	正面	正面
剧情爆满，有笑点有温馨，麻花一如既往，画面不比美国大片差	正面	正面
超级好看！！！非常搞笑也非常感人	正面	正面
前半部分麻花式搞笑，后半部分堆时间煽情	正面	正面
还可以 特效真的好👍	正面	正面
睡着了，真无聊	负面	负面
一般般的一般	正面	负面
喜剧却是悲剧结尾，生活本来就很累了，不能快乐一点吗	正面	正面
边哭边笑～～	正面	正面
真的很好看，是那种眼泪还挂在脸庞，你却又笑了的感觉。用喜剧的方式给我们呈现了大部分人所认同的现实意义。这部电影拯救了我这一段时间以来的糟糕心情！也让我对一些忽略的小事开始深思，推荐	正面	正面
好看，带小朋友一起看了，小朋友对月球很感兴趣	正面	正面
喜剧片挺好笑的	正面	正面
我太喜欢了，一家三口去看的，有笑点有泪点，沈腾出品，必数精品。喜欢	正面	正面
还可以，音乐也特别好	正面	正面
强烈推荐失眠的过去睡觉😪	负面	负面
有搞笑，也有感动	正面	正面
看完大家都摇摇头走了,  不好看, 单纯从电影效果, 还是深层主题	负面	负面
可以看的进去	正面	正面
我愿给到五星🌟，因为布景非常用心，太太太棒了！	正面	正面
个人觉得很好，有搞笑的地方，抒情的地方也很感人，而且特效算挺好的了，值的去看	正面	正面
太好看了有笑点有泪点，是我本年度看过最好看的电影 呜呜呜太伟大了，这就是人类创造无限的精神	正面	正面
喜欢沈腾，但电影内容有点无厘头搞笑	正面	正面
看也行，不看也行🌝	正面	正面
电影催眠效果不错在电影院睡了一个多小时	负面	正面
一般般。普普通通	负面	负面
我只想说这部电影绝绝子，太好看了	正面	正面
其实并没有想象中那么搞笑，高估了，反倒是古天乐的明日之战不负期待推荐大家去看	负面	正面
好看。，笑点很多	正面	正面
沈腾真是个人才	正面	正面
又喜又悲，稀里哗啦的	正面	正面
半星都不想打，中国人不骗中国人，真是蛮失望。半个小时我就想退场了，但是我坐在中间，下场耽误其他人的观感，所以我坚持到了结束，几乎是隔一段时间看下时间，想着赶紧结束。	负面	负面
特别好看。喜欢	正面	正面
推荐推荐，哈哈(ಡωಡ)hiahiahia	正面	正面
电影很不错！！！	正面	正面
带着老人去看的，全场都是笑声，值得去看一看	正面	正面
还不错，没有特别戳到我的笑点	正面	正面
中规中矩 上个厕所依然不影响我看剧情，没有什么槽点。	正面	正面
滑稽滑稽时代先锋	负面	正面
一贯的开心麻花搞笑风格，笑点密集，可以一看。	正面	正面
挺好的 开心麻花没让我失望	正面	正面
还不错有可能几十年后我们真的会经历这一切	正面	正面
剧情还可以，搞笑里面有有感情	正面	正面
前中期搞笑后期感人	正面	正面
我也想去月球	正面	正面
好看好看好看 🌟 推荐	正面	正面
说实话太一般。看完全程让人无语，剧情比较烂，跟夏洛特烦恼真的差太多了。完全不值得这个票房，本来想着看看喜剧开心一下，结果全程没有值得笑得地方，比较尬。	负面	负面
好看，真的好看！强烈推荐！ 🌟 推荐  🌅 画面  🎉闪光点  😭 哭点  😂 笑点  🌟 推荐  🌟 推荐	正面	正面
真好看，腾哥的演技没的说，全程爆笑不断！！	正面	正面
袋鼠挺可爱	正面	正面
怎么说呢，腾哥贡献了几乎全部的笑点	正面	正面
一般吧。就是有点没有看懂。	正面	正面
好看剧情好看	正面	正面
太搞笑了👍	正面	正面
可以，不错。。	正面	正面
反转太刺激，哭哭笑笑	正面	正面
影片开场不算特别惊艳，剧情也很一般，但整部影片特效做的特别好，让我们地球人体验了一次登陆月球的感觉，画面很逼真，看的出来导演为此费了不少心思，影片中途还加了一首杨钰莹的《亲亲的告诉你》，瞬间又带我们回到那个美好纯真的年代，体验了一把初恋的滋味，金刚鼠的出现，给整部电影增加了一些喜剧色彩，看这部电影我就是冲着腾哥去的，有笑点更有泪点，让我感触最深的就是我们人类在遇到灾难的时候，是如此的渺小和无助，又看到了人类面临灾难时的勇敢与坚强，宇宙那么大，我们还会再遇见，我们没有时间浪费，珍惜当下，把每一天都当做世界末日去对待！	负面	正面
全程笑到尾哈哈哈	正面	正面
剧情挺好的有笑点有泪点	正面	正面
虽然某些情节有点扯，但不影响剧情，好看，还有些感人	正面	正面
真的跟不错，沈腾的电影是一如既往地好看	正面	正面
不是很好看呢。可以当喜剧看	负面	负面
笑死人了的悲剧。	正面	正面
非常不错。值得看一看。	正面	正面
剧情不错前面搞笑到后面有泪点	正面	正面
剧情老套，没有新意，节奏上也有点拖沓，搞笑的镜头不多，很勉强的剧情，没有代入感。第一次觉得沈马组合失败的电影。	负面	负面
呜呜呜，哭了	正面	正面
马丽沈腾的电影太好看了	正面	正面
教育意义太重了，我想纯粹的看喜剧	负面	正面
好看，剧情很精彩	正面	正面
上个月球家都被偷了	正面	正面
记得记得就睡觉就是嫁鸡随鸡看看上课	正面	正面
还可以吧  袋鼠很逼真  剧情一般   我心中开心麻花的最好的作品还是夏洛特烦恼   这个电影还不能超越	正面	正面
好看，好看，好看。说的再多也没有去支持一下有劲。	正面	正面
一直在笑，后面也有泪点。虽然有些经不起推敲的地方，但是不失为一部好电影。	正面	正面
和“魔丸”一样的结尾，生命体消亡，精神永存	正面	正面
有喜有悲，不错。	正面	正面
剧情很无语……一喜剧片搞悲剧结尾 我是去放松的不是被你教育的。笑点也不密集 沈腾演技很奇怪 马丽倒是惊喜 但戏份不多 也没有特别大互动 不是很满意	负面	负面
快睡着了哈哈哈哈	正面	正面
每月一部东北二人转	负面	正面
真的爱了，又感动又搞笑	正面	正面
挺喜欢喜剧的。生活那么苦，总要一些开心的东西。但是结局不太喜欢	正面	正面
制作精良，情节在意料之中，笑点泪点都有，比什么《羞羞的铁拳》有意思多了。	正面	正面
好看！真的好看！冲！	正面	正面
值得一看，笑点多…	正面	正面
搞笑，画面也不错	正面	正面
值得一看 没有想象中那么搞笑 不过也能带动心炫 值得一看	正面	正面
操心感动热血就是有点扯	正面	正面
唉，抱着期待去看的，干脆叫尬行月球吧，太失望了，强行煽情，逻辑扯淡	负面	负面
流浪地球之后比较有意思的科幻喜剧，搞笑开心麻花是认真的！值得推荐	正面	正面
111为这难得的氛围和服务，我也必须来个好评，赞赞赞	正面	正面
真的很好看  一定要认真去看	正面	正面
相当可以的哦	正面	正面
真的不好看不知道演啥呢，题材完全不新颖	负面	负面
还可以，。，	正面	正面
挺好看的，就是没有最后的强行煽情就好了	正面	正面
好看欢快，没网上说的那么不堪	正面	正面
这部电影值得一看！	正面	正面
一般般，看了一个半小时走了！	负面	负面
特效好，剧情棒，真的很推荐，哈哈哈哈哈哈哈哈哈哈	正面	正面
看了觉得还可以	正面	正面
总的来说可以看看	正面	正面
不戳真不戳啊	正面	正面
不是很好看	负面	负面
很感人，很有喜剧话	正面	正面
剧情紧凑，立体宏大，极尽开心，也有泪点，值得一看	正面	正面
好 记录好看	正面	正面
值得推荐看，很搞笑	正面	正面
还不错，挺震撼	正面	正面
很一般 一般	负面	负面
剧情很丰富，角度很独特，又好笑，又好哭，很喜欢，是那种还想看第二次的电影，推荐	正面	正面
很久没有看过这么好看的电影了	正面	正面
一般般，强行搞笑，没新意！	负面	负面
一如既往的不错 一如既往的好评不断	正面	正面
有笑有泪 挺不错的	正面	正面
🌟 推荐  🥚 彩蛋 🎉闪光点 看完之后还是觉得它没有让我失望，甚至于超出我的预期。首先就是电影充分体现了沈腾的演技，面对孤独，在摆烂和认真两种态度中飘忽不定，但最后还是坚定不移选择了对地球负责。其次，电影中刚子的设定让我大为震惊，正是因为刚子的存在，整部电影的剧情更为跌宕起伏，也丰富了情感。除了沈腾和马丽情感变化之外，还有人和动物产生的独特情感，以及幸存者们的心理变化，真的是深入人心。整部电影的剧情设定以及结局的彩蛋也是太欧亨利了，意料之外情理之中，充满了伏笔和暗示。所以说尽可以相信老沈和马丽的合作作品，我只能说YYDS。虽然在我们的一生中大概率不会出现这样的事情，但这部影片还是在激励着我们，即便是独自遭遇困境也不要放弃一线希望，哪怕只有那样渺小，这是我高中生涯最后一个暑假，之后的高三生活我会用独孤月来激励自己，尽力而为，成为自己的英雄，成为一颗能发出微小光芒的星星也足矣。最后用电影谢幕后的一句话：宇宙这么大，我们还会遇见！希望没看过的小伙伴们有时间体验体验这份宇宙级浪漫吧！！！	正面	正面
还不错，剧情单一，后面有点拖沓。	正面	正面
前半程搞笑，后半程感人	正面	正面
很好看 喜欢刚子	正面	正面
剧情很好，特效和道具都在线，专业方面的东西我们不懂的，觉得好厉害。强推一下！	正面	正面
不得不说，沈校草长在了我的笑点上！诙谐幽默，是布不错的电影。	正面	正面
特好，好久没看到这么好看的电影了	正面	正面
剧情一般般没有说很好，但是演员的演技非常棒，而且特效也非常好。 😊 演技  🌟 推荐  😭 哭点  🌅 画面  ✨观影贴士	正面	正面
开始很好笑，之后也有悲痛。值得观看。	正面	正面
没有传说的那么好看……	负面	负面
很好看，很搞笑又很感动，尤其是里面的刚子，我记住你了，呵呵，很棒的一部电影，神马组合棒棒的！	正面	正面
挺好看的，有意思	正面	正面
非常喜欢，前面笑点不断，后面竟然还有泪点😹	正面	正面
很好笑的电影！笑出泪花！推荐！大家去的时候带上纸巾！	正面	正面
还行，不如以前的麻花	正面	正面
喜剧片？科幻片？分不清，最后在太空扛着原子弹去炸陨石！！！现在的电影宣传太水了！！！	负面	负面
本来冲着沈腾马丽这对组合去的，结果全程尬笑……	负面	负面
二刷，喜欢开心麻花团队的表演	正面	正面
现在的电影也就那样吧，说不上精彩，也许是年龄段原因吧，个人觉得适合情侣看吧	正面	正面
我觉得这是一部艺术性大于喜剧性的影片 前半部分麻花的搞笑依然在 后半部分高度升华真的很绝 特效做的也不错 演技全员在线！！！ 刚子也回了地球 生了好多小袋鼠！	正面	正面
相信我 是真的不好看 ，可能是我期望值太高了，剧情太烂了，强行煽情 给我看困了都	负面	负面
笑比泪多，科技感满满，祖国真得太强大了！快去看，不看一定后悔！人间星河，我们还会再见！	正面	正面
一般般，没啥惊喜	负面	负面
特效满分，剧情六分，演技七分。	正面	正面
挺好看的，有笑有泪。喜欢腾哥的可以去看，特效差点，不过还算可以吧。	正面	正面
剧情真的特别好 前面嘎嘎搞笑 后面很催泪 有机会一定要看看看！！！	正面	正面
沈腾出手，必是精品	正面	正面
随着伟大祖国航天航空领域的建设和开发，科幻片制作的越来越大牌！	正面	正面
一切ok。棒棒	正面	正面
好看，推荐，含腾量百分百	正面	正面
全程无尿点，真的很不错。	正面	正面
综合还是挺搞笑的含腾量特高	正面	正面
不错，挺好的，很有剧情，搞笑类的	正面	正面
挺好看的，很值得	正面	正面
装修非常有品味，店面也很好找，停车也方便，交通非常便利，这点夸夸	正面	正面
比较吸引眼球，俩个主角虽然年记比较大，但是看着没有做作的感觉，非常喜欢，值得看。电影情节也很有趣，很欢快的节奏，看着很舒服	正面	正面
好笑，沈腾没有袋鼠演的好。	正面	正面
搞笑也感人！	正面	正面
全靠演员撑着。	负面	正面
整体节奏把握得很好，喜剧元素与科幻元素的平衡控制得当，既不出戏，又颇显浪漫温馨。这部虽然搞笑方面略尬，袋鼠和配音演员梗比较生硬，但作品表达的核心，即困境中求生和互助的主题烘托得自然到位，尽管剧情走向都能猜到，但过程还是显得既合情合理，又浪漫动人。个人觉得这部作品最成功之处在于，避开了传统特效科幻的套路，避免了以中国电影短板去硬杠好莱坞的局面，而是另辟蹊径，以轻喜剧版末日求生的主题，走出了相对符合开心麻花特色的模式。但在特效领域也有明显进步，相比类似玩法的《疯狂外星人》，基本做到了让观众沉浸设定中不出戏，个人认为这种程度的把控是最终大卖的原因，这类主题不需要非常硬核的科幻设定，但把控搞笑和特效的尺度，做到让多数观众接受设定，享受剧情并不是简单的事。观影体验方面，虽然与国内外顶级科幻片还有一定差距，但足以能感受到制作方的诚意，无论剧本、细节还是音乐的融合都达到了相当高的完成度，个人认为可以打7.5分，这是即《流浪地球》后，第二部让人看到国产科幻希望的电影。	正面	正面
特别棒，推荐	正面	正面
无厘头的喜剧	正面	正面
with杜承轩 孙斌 2022.0731	正面	正面
电影没有想象的那么好，但也很不错。	正面	正面
很搞笑很感动	正面	正面
蛮好的，为了看结尾名单里我前男友的名字去看的，哈哈哈哈哈哈，宇宙这么大希望我给他不要再见面了	正面	正面
永远相信沈马组合！永远相信开心麻花！yyds！	正面	正面
很好看  我可以扛起整个银河的力量 却无法承担一滴你想念的泪水	正面	正面
非常好看，剧情流畅，又搞笑又感人	正面	正面
挺好看的，带着孩子去的，途中都笑了好久	正面	正面
好看，腾哥出演必冲	正面	正面
很不错，没失望，满意。	正面	正面
虽然是喜剧，但是想要表达的主题却是很伟大的。在看这部电影的时候，我就在想，也许以后我们的航天员也会经历那样的时刻。到底是选择自己活下来还是为了全人类、全地球与陨石一起毁灭，这对他们来说应该是难以抉择的。就像独孤月一样，在那样悲怆的选择的背后，是他对地球家园的爱，而这种爱足以抵过对自我生命的珍惜。不得不说沈腾马丽出手，笑点是很足的，几欲泪下的时候突然的一个笑点就会让你笑出鼻涕泡，倒也不会很难受。总之我觉得这部电影很好看，从剧情，主题，故事性等方面来说都挺对我胃口的。	正面	正面
好看，又搞笑又狠狠赚了我一波眼泪，和夏洛特烦恼不是一个类型的不做比较，好看	正面	正面
不错哦很好啊	正面	正面
无聊透顶，看40分钟睡着了。垃圾	负面	负面
世界上有几种喜剧模式 一种看了笑岔气了，过后就忘了 还有一种，看了大笑了  哭了   震撼了   沉默了遗憾了～最终你还是笑了 看了，才知道喜剧内核是悲伤是遗憾， 笑着流泪 影片中，除了几个演技派大手，都是小演员，黄子韬毁形象出现有些意外，整部电影都投资在特效上了片头片尾也很是制作精良	正面	正面
画面感十足，一开始是冲着沈腾马丽老师去的，没想到有好多老演员了，观感体验很好，毕竟好久不看一次电影看一次电影就会让人激动快乐感动流泪，真的很容易让我泪目，明明不是个泪目的人哈哈，内容也很科技感，月球科技知识和人们之间的沟通还有那个刚子哈哈哈，大家冲啊！	正面	正面
一般般吧，爆米花电影	正面	负面
还不错，有欢笑有感动	正面	正面
还可以，一般吧	正面	正面
🌟 推荐五星推荐，好看哭了  😊 演技 超赞的演技	正面	正面
非常好看呢。	正面	正面
挺好的，很棒	正面	正面
剧情完整，科幻场景特效很棒！表演不尴尬！有喜有泪！值得观看！	正面	正面
真的很搞笑，不错	正面	正面
我觉得非常好，真的很好	正面	正面
音乐挺好听的 剧情还算不错吧，还是有点梗在里面的	正面	正面
全程都在笑无尿点，最后冲π2很感人。	正面	正面
好好看 很不错	正面	正面
好笑陛下乚55555	正面	正面
开心麻花的电影我一直都很看好，欢笑中带着感动，独孤月说他平凡，可是他又有很高的技术，说他不平凡，可是他是＂中间人＂，虽然中间有些剧情我都猜到了，但是看了之后还是会感动，最后他牺牲了自己拯救了地球，拯救了他爱的她以及他们，他很伟大，其实我们生活中有很多这样平凡的人，因为有了他们，我们的国家才会这么富强，感谢你们，也感谢祖国。	正面	正面
非常值得一看	正面	正面
一般般吧。。。	正面	负面
刚看完，开心麻花的电影看了就是开心，虽然沈腾演的独孤月最后牺牲了，但是情节还是以笑点为主，真希望开心麻花能为影迷们拍出更多更好看的电影，真心期待......好久没看见影院这么多影迷了，基本座无虚席	正面	正面
真的好看哇哇哇	正面	正面
看就完事了，带我妈去看的，笑的肚子疼	正面	正面
看完真的破防了，在看电影的过程中一边哭一边笑，沈马组合yyds，可惜就是be了   📚 剧本非常nice	正面	正面
还是很不错的，既搞笑又感动	正面	正面
感觉还不错 可能是对沈腾马丽太过期待了吧  不管搞笑还是煽情都感觉还好 没有特别戳到我的点	正面	正面
题材还可以，挺好看的	正面	正面
一般般吧，不是特好看，也不难看	负面	正面
特别好看。一次愉快的观影感受。	正面	正面
好评 相当的搞笑 适合带宝宝看	正面	正面
整体看起来还行	正面	正面
可能这就是中国喜剧吧，喜中带点遗憾	正面	正面
对比今年我看到的电影（侏罗纪世界3），感觉诚意满满。沈腾和马丽的再一次合作，有笑有泪。 最难的是怎么在一个严肃的大框架下填充小的内容。但最终还是没让我失望。尤其最后的一句：马蓝星，送我回家。泪点满满	正面	正面
都是老演员，而且我觉得特效一点都不比流浪地球差，反正值得一看	正面	正面
剧情还是可以的，开心麻花的电影剧情还是不会让人失望的，而且钱也用在刀刃上，特效方面也是挺不错的。笑点多，不会让人觉得尬。很不错的一次观影！！棒棒棒👍🏻	正面	正面
哭了哭了真的太好看，太爱了，估计以后能刷好几次，希望有机会能刚子	正面	正面
支持沈腾马丽  好看  有笑点有泪点  最后我以为能有个反转  😂	正面	正面
整体观感还是不错，最后结尾有点泪目。	正面	正面
很值得看的一部电影！！	正面	正面
好看哇 超级喜欢沈腾	正面	正面
第一次结局是be，但真的太好看了。	正面	正面
画面太美 笑点很高	正面	正面
开心麻花的风格！整体上可以！大家就是开开心心找个乐嘛！没必要较真儿！	正面	正面
我觉得没那么搞笑唉	正面	负面
看喜剧片看睡着了，全程不搞笑，结尾强行升华，造夏洛特烦恼和西虹市首富差远了	负面	负面
， 哈哈哈哈	负面	正面
还行，笑点蛮多的，特别是金刚鼠刚出场的那一部分，给我带来了不少的欢乐 😊 演技  🌟 推荐	正面	正面
真的喜欢看他们演的不错	正面	正面
剧情还好，画质很好，还可以	正面	正面
很好，很有创意的一部作品。	正面	正面
就……很无聊很无聊…真的….	负面	负面
腾哥和丽姐演技真真没话说。但我想重点提一下金刚鼠，虽然没有演员的露面，但他的一举一动，各种眼神，各种动作，可想背后付出的辛苦有多少，为了这个片子，演员苦练了一年👍	正面	正面
好看呀，很精彩。	正面	正面
非常的有意思	正面	正面
一般般吧，是我期望太高了吗？没有达到预期效果	正面	负面
特别棒，很震撼人心	正面	正面
挺不错的，推荐去看	正面	正面
很棒，棒棒棒	正面	正面
真的不错，很喜欢。	正面	正面
观看独行月球这部电影特意选择了最棒的特效厅，CGS中国巨幕杜比全景声影厅，银幕大，音效强，沈腾真的牛！整部电影他的独戏得占一半，还能拍得这么有意思，拜服！刚子直接融化我的心！总之，冲就对了！	正面	正面
好笑又好哭🚀🛰值得推荐	正面	正面
一定一定要去看	正面	正面
笑点很多，不错的一部影片，感觉沈腾和马丽的每部影片都不错	正面	正面
不愧是沈腾演的，非常完美。该逗笑的地方逗笑……反正就是很完美。	正面	正面
可以，整体蛮好看	正面	正面
好看极了，下次再来	正面	正面
电影里那些涉及月球，科技类的词汇超出我的认知。但不妨碍它把我逗笑又逗哭。看到沈腾和马丽第一反应是它会和夏洛特烦恼一样好看吗？看完后我觉得这是两部不一样的电影不能做比较。	正面	正面
演技炸裂，科幻带搞笑新意不违和	正面	正面
非常感人，好看	正面	正面
一搬搬，不怎么喜欢	正面	负面
感人，搞笑，真诚，人和动物共存，笑声带浪漫和感动	正面	正面
好看，感情戏加码	正面	正面
满满的喜剧和感动，不必杠那些剧情需要，电影就是观众想看导演敢拍……	正面	正面
前面很搞笑，后面很感人还不错	正面	正面
剧情不评价，单看搞笑和泪点都有，画面不错，演技上乘，适合一个人欣赏，一个人感受，多人也不是不行。	正面	正面
激励人心，搞笑	正面	正面
咱就是说非常快乐 很好看了 很多小细节也照顾到了！！！ 就真的良心制作 哈哈哈哈 大家一定都要去看！！！！	正面	正面
爆笑，超级好看	正面	正面
有腾哥的电影果然没让我失望，搞笑加感动加科幻，情节内容十分有看头，真心点赞！推荐去看，拍的太好了。	正面	正面
有点意思，值得深思	正面	正面
泪点喜点都有	正面	正面
还行吧，可看	正面	正面
超棒，沈马组合，而且袋鼠神情真的到位了	正面	正面
为啥现在每个喜剧后面都要加点悲剧？	负面	正面
好看，不错，可以！	正面	正面
非常好，小孩喜欢看	正面	正面
从头笑到尾，含腾量极高，袋鼠的演技炸裂，满身笑点。	正面	正面
看完这部片子，暂且不议论科学性啥的。我就想问一句：男主独孤月，上海交大飞行器动力学专业，在月球独立完成废旧航空发动机的维修、装卸和运行的人，就因为是维修工自称为平凡的“中间人”？这是在侮辱维修工还是凡尔赛啊？现在连平凡人都这么卷吗？	负面	正面
好看，但是很多梗老年人看不懂，不是很老少皆宜	正面	正面
马蓝星给独孤月塑造英雄形象，后面真成英雄了。结局马蓝星及成员们再次登月，希望有第二部，独孤月没死，一直在月球等着马蓝星	正面	正面
奔着沈腾去的，确实有不少笑点！！！	正面	正面
挺好的，😳	正面	正面
影院不错，片子一般。	负面	正面
好看电影🎬	正面	正面
有喜有悲，结局让人意外	正面	正面
挺好的  很好看  金刚鼠顶流	正面	正面
前面还行 后面煽情 比起沈腾其它作品差劲	正面	负面
把你逗得哈哈大笑的同时 又能让你心灵触动 搞笑的同时触动心弦 全剧跌宕起伏  情节紧凑 步步悬念相称	正面	正面
不愧是开心麻花，电影质量这么好，最后化作一个光环守护着马蓝星，守护者地球。	正面	正面
真的很好.就是刚开始很搞笑，然后到后来真的就很感动了，特别想哭到最后。	正面	正面
感觉小孩子会更喜欢一点	正面	正面
还可以 不是很惊喜	正面	正面
值得一看，开头搞笑，结尾感人	正面	正面
看到最后都忘记沈腾是演员了，果然沈腾和马丽搭档非常nice💖突然就觉得回去救袋鼠的沈腾还挺帅，后来的牺牲有点催泪了。	正面	正面
开头还有些搞笑，可惜最后沈腾角色牺牲了！唯一一部腾哥牺牲的电影	正面	正面
完美，真的很好看	正面	正面
看完真的很心疼独孤月这个角色，一开始被抛弃在月球，好不容易可以回去了 又被道德绑架去拯救世界，特别是最后出现袋鼠的雕像，大家把它当作英雄了，可是真正的英雄阻挡了派+的独孤月仿佛没人再记起，但是独孤月仍然是爱着地球爱着同胞们的，最后变成星环环绕着地球，他也回家了	正面	正面
前半段搞笑，后半段感人，总体很不错，能让人产生共鸣	正面	正面
虽说预期高于实际，但还是可以的，这类题材，以后还想看	正面	正面
好看，笑死了	正面	正面
垃圾啊。无聊又幼稚	负面	负面
挺好看的，搞笑的同时也很感人，喜欢沈腾马丽~~~	正面	正面
🎉闪光点金刚鼠永远的神   😂 笑点八级钳工，袋鼠胖揍   😊 演技给你九分怕你骄傲，剩下的一分把独孤月复活   📚 剧本剧情有点过快    😭 哭点结尾独孤月的去世，从新登录月球   ✨观影贴士请忍住自己的笑意，不要影响大家观看  🌟 推荐强烈推荐观看	正面	正面
言情不像言情，科幻又不科幻，搞笑又不搞笑，没灵魂	负面	负面
搞笑，还不错	正面	正面
好看好看好看 不看后悔系列 （刚子真的好笑）	正面	正面
剧情可以蛮好	正面	正面
刚刚更换哈哈斤斤计较	正面	正面
感动又好哭。	正面	正面
搞笑，感人拍的挺不错的	负面	正面
欢快中令人深思	正面	正面
非常好的一个科幻片	正面	正面
还不错，加油！	正面	正面
剧情很搞笑，划重点那个葫芦丝～	正面	正面
非常的好看，赞	正面	正面
实在是太搞笑啦	正面	正面
还好吧，一般般	正面	正面
好看，喜欢沈马cp😘	正面	正面
孤独不是受到了冷落和遗弃，而是无知己，不被理解。真正的孤独者不言孤独，偶尔作些长啸，如我们看到的兽 ——《孤独地走向未来》贾平凹	正面	正面
难看，无聊至极	负面	负面
很不错，一如既往的好	正面	正面
感动，搞笑，含腾量满满的。	正面	正面
刚子，BGM拉满了 腾哥，马丽依旧搞笑 最后也是慢慢感动，很棒，是最近看的电影中最好的电影	正面	正面
好看的，不错哦	正面	正面
整体感觉还好，笑点有，泪点也有！结局如果换下更好！	正面	正面
前面剧情很搞笑，但到后面就开始比较正经一些了，总体来说沈腾和马丽的再一次组合真的挺不错的！	正面	正面
一群无聊的垃圾人  能拍点有水平的电影吗？骗钱骗到家了。居然还有这么多无聊的人去陪着演戏。吃饱了撑的！！！！	负面	负面
看前半部分还以为会是火星救援这种大团圆电影，没想到祸不单行，福无双至啊，可恶的导演，让沈叔叔大团圆会怎样啦。 场景特效非常喜欢，宇宙的浪漫和恐怖在这里体现的很好	正面	正面
朋友推荐使用的平台，这里的活动都好划算，到店消费也很方便，非常棒🤞	正面	正面
hantengliangbaifenbai	正面	正面
还可以，整体来说又喜又悲，真值得一看	正面	正面
真的超级好看!	正面	正面
含腾量100%，电影前半段基本上有他的镜头就有观众在笑，他已经变成了大家只要看到他这张脸，就忍不住咧嘴笑出声的程度。尤其这部沈腾的表演，完美诠释了一个“喜剧”演员无限的表演可能性。再次搭档马丽，两个人物衡跃在银幕的戏剧浓度，也深厚了不少。  电影整体就像是经典电影中的“荒岛求生”模式，月球与地球之间的联系，也像是楚门的娱乐秀，只是更新换代至此，还利用了现代直播的智慧形式，但在这里面也引申出一个很有深意的思想，那就是：支撑我们活下去的信念，对于人类是无比重要的。  之前说，科幻喜剧是未来电影创作的大方向，而所有喜剧的最高境界，就是展现普通人不凡的孤独，这部电影做到了！	正面	正面
好看，影院差评，没有爆米花😡	负面	正面
冲着沈腾和马丽去看的，含腾量百分百，开心麻花果然没让我失望，充满科技感的喜剧片，特效很燃，黄子韬看脸就蛮想笑的hhh有笑点有泪点，片中的插曲选得很好，当时氛围满满。	正面	正面
挺不错的值得一看	正面	正面
开创了中国人文科幻电影的新高度 又好笑 又科教 又感动 真棒加油	正面	正面
前半部分还不错，后面煽情就有点不习惯了，画面倒是不错，尤其刚子拉沈腾，银河下的画面，有点意思	正面	正面
真的不错不错	正面	正面
搞笑，催泪都有了	正面	正面
很好 很好h	正面	正面
有哭有笑 🌟 推荐	正面	正面
我很少评价一个电影，这部电影本来就冲着玛丽和沈腾去看的，结果从开始就笑料不断，笑得眼泪都掉下来了，到最后的感动。看得我意犹未尽的，还想在看一遍。	正面	正面
非常好，有感染力	正面	正面
总的来说还是可以的，含腾量比较高，有搞笑的色彩，不会像吴英雄主义那么强烈。	正面	正面
科幻片？这么煽情！！！错把滑稽当有趣！真后悔带着儿子和他同学看了这部电影！因为我看了不到半小时睡着了，当着儿子同学的面居然发出呼噜声！丢死个人！！什么玩意！	负面	负面
挺搞笑，挺震撼，挺感人的	正面	正面
我觉得很好啊，不知道有些人怎么想的	正面	正面
麻花的作品，个人还是很期待以及喜欢的，特别是马丽，她一说话我就想笑。 但说实话，这个片子的笑点我没有很接到，然后，就是立意也不是很cue我的点，有一点点“四不像”的感觉，当成科幻片呢，又没有同类型的《太空旅客》抓人，整体略失望，但永远喜欢沈腾马丽。	正面	正面
2个小时没觉着无聊，但也没有看第二遍的冲动。 还不错，就是票价挺有意思的，前2排31元，其他座位38元	正面	正面
很好旁边人哭的不像样	正面	正面
真的好喜欢沈马😍😍太好看了！！	正面	正面
影片很好看，很感人，非常不错	正面	正面
我曾经两次放弃你，都是为了那个所谓正确的事情，反转太多，有点生硬，好在沈腾叔叔演技撑起整部电影	正面	正面
前面很搞笑。后面很感人！	正面	正面
挺好看的推荐大家看	正面	正面
沈马cp给我嗑！！！！！	正面	正面
挺搞笑的啊，哈哈	正面	正面
也就挺搞搞笑的	正面	正面
可以很不错哦	正面	正面
好看、小感动	正面	正面
咋说呢？这个电影前一半还算是比较不错，后面比较拉胯。但整体来说这个剧情还是非常不错。	负面	正面
剧情有笑有泪	正面	正面
好   特别开心	正面	正面
好不错哈哈哈哈	正面	正面
很好看的，很不错的人电影	正面	正面
很有趣，推荐	正面	正面
超级好看想二刷	正面	正面
请问含腾量有多少	正面	正面
里面关于科幻元素的设定挺不错	正面	正面
非常过瘾，搞笑又深情。没想到这么棒，比夏洛特的烦恼更好。	正面	正面
还行吧，没有之前呢的那么狂快乐了。	正面	正面
宇宙这么大，我们还会遇见。	正面	正面
很好看 结局出乎意料	正面	正面
对我这个小老百姓而言，我觉得挺好看，有哭有笑，很细微	正面	正面
一如既往地好	正面	正面
好 好好hao	正面	正面
电影很好看 喜剧伴着悲剧	正面	正面
确实好看，笑中带泪	正面	正面
含腾量很高，有笑点有泪点，有意思也有责任担当，看完不后悔的电影，适合全家人一起看，后面的彩蛋让人泪目，很奇怪只有独孤月不带头盔，原来他只是个影子了	正面	正面
给孩子们订的票，孩子回来说只要是沈腾的电影，那就绝对的经典，这一次也是超级无敌好看哦！	正面	正面
好嗑！真的好嗑！	正面	正面
一切都非常美好完美	正面	正面
挺好看的一部	正面	正面
永远可以相信沈腾与马丽，剧情好，演技不用说，画面美丽，一直笑和感动之间切换。棒棒棒	正面	正面
好康，开心麻花团出剧必追 🌟 推荐	正面	正面
这是一部“含腾量”很高的电影   值得二刷	正面	正面
沈叔叔的剧肯定值得去看，只是最后有点可惜	正面	正面
算可以看看吧，也体验一次自己看电影，“原本我已经习惯了孤独，可是后来才发现生活的意义就是当你加班回到家的时候有人为你亮着一盏灯，累了的时候有人陪你喝杯酒，陷入低谷的时候有人给你一个温暖的拥抱。”	正面	正面
总体还不错，中后部分剧情稍微有点儿拖拉，打瞌睡了	正面	正面
剧情很精彩，极力推荐	正面	正面
首先，在我看来，这部剧非常用心，有很多细节惊喜，包袱多，同时也非常催泪，三观超正，为了全球人民，牺牲自己	正面	正面
很赞 希望越来越多的科幻电影能做好	正面	正面
就，看看也还行吧。 我带了男友，奶奶，妈妈，姑姑，嗯，一行五个人，除了我和男朋友，她们都睡着了，睡得很香。	正面	正面
只要是麻花的电影，小品，话剧都有麻花独有的艺术风格和喜剧特点。笑着笑着就哭了，导演眼光独特，演员表演奇特😁😁😁🌹🌹🌹🙏🙏🙏	正面	正面
很好看，又哭又笑	正面	正面
挺好看的，笑点挺多，很好…	正面	正面
还可以，挺逗的	正面	正面
剧情真次 演技更别提了 大家都很浮夸 看起来不太聪明的样子 中国电影感觉不行了	负面	负面
哭死了 很感人	正面	正面
看电影就是消遣，图个乐，不用那么认真	正面	负面
挺好棒棒棒棒	正面	正面
非常好看，推荐大家去看。	正面	正面
很好找很好看	正面	正面
超级搞笑很不错！！	正面	正面
二刷，总体来说还是比较满足预期的，够搞笑，但是整体剧情转变太快，总感觉有点仓促	正面	正面
剧情很拉胯 一点不好笑	负面	负面
开心麻花爆笑	正面	正面
中国的科幻特技效果已经可以与好莱坞比肩了。	正面	正面
挺不错，可以	正面	正面
浪费时间和钱	负面	负面
一般吧，喜剧不喜，煽情就那样。不是演员不行，这剧本太邋遢，导演太邋遢，反正各种邋遢。	负面	负面
还行，去看看吧！	正面	正面
沈叔叔发挥超常，孤独月马蓝星太甜了呜呜呜锁死啊	正面	正面
好看，剧情也好	正面	正面
冲着肥沈去的 整体还行 没太失望，	正面	正面
一般般，没有之前几部好看	负面	负面
真的很搞笑去看去看	正面	正面
剧情一般，特效还行	负面	正面
起起落落恰似人生，有开心有难过，有相聚有一次次得擦肩而过直至永恒，be最是人间意难平。	正面	正面
非常值得看！	正面	正面
有点意难平，不过这个结局应该是最好的结局了🥺	正面	正面
好看，很搞笑的，腾哥电影必看的。就是后小半节奏慢了点。	正面	正面
非常好看，沈腾马丽的电影从来没有让人失望过，推荐去看	正面	正面
不愧评价这么高，可以算是实至名归了，会推荐给朋友的，扣一分是因为票丢了	正面	正面
好看，以后会	正面	正面
哈哈哈 含腾量100%～真的好看	正面	正面
不错二大队反反复复	正面	正面
很好非常喜欢	正面	正面
失望太失望了	负面	负面
非常不好看 烂片 也不知道分为什么那么高	负面	负面
好看，快乐就完了	正面	正面
不错，非常好	正面	正面
独行月球这部电影🎬搞笑之余又有教育意义，适合一家大小观看。	正面	正面
很不错 离家近 很方便 环境还行	正面	正面
特效很棒，题材也算不错，但是对于搞笑和煽情的边界界定有点模糊，个人观感不如夏洛特和西红市	负面	正面
非常好的一部电影，喜剧科幻片，很新颖，也很有深度，感谢张吃鱼导演！	正面	正面
感人，不错推荐	正面	正面
可以去看看，不过梗稍微有点老套	正面	正面
可以还不错的	正面	正面
结果值得去看	正面	正面
挺感人的，看哭了	正面	正面
沈腾一人撑一部剧	正面	正面
剧情单调乏味不新颖，演技没什么突破，包袱也不多	负面	负面
好，非常不错的	正面	正面
太搞笑了，金刚鼠全剧的点睛之笔。细节，剧情感人又搞笑。	正面	正面
含腾量很高，值得票房，不是纯喜剧，结局感人，推荐。	正面	正面
结局不满意，大家只想看想看到的结局	正面	正面
挺好看的，剧情非常欢乐，可惜喜剧的最后还是以悲剧收尾	正面	正面
又哭又笑 感觉不错	正面	正面
影片笑点屈指可数，中间本应该是最搞笑片段的男主和袋鼠斗智斗勇没让我觉得很好笑，反而有点无语，没觉得很好笑。后半段出现的煽情片段催泪，整个电影不如说煽情片段出现的比搞笑片段还多。最后男主牺牲自己的剧情也有些老套。作为喜剧片并没有在看完后有很好的心情，没有想再看一遍的想法。	负面	正面
挺搞笑的，看的时候大家全程都在笑，很有氛围	正面	正面
那些看似平凡又碌碌无为的人，却在需要他们的时候，他们会毫不犹豫挺身而出	正面	正面
不错，笑点还行	正面	正面
没的说，必须棒棒的	正面	正面
最后给我哭s了	正面	正面
国产科幻又一次成功突破 画面太美 感情线不尴尬	正面	正面
不错的，很值得一看	正面	正面
看的想睡，看到一半想走…	负面	负面
好看，超级感人的	正面	正面
我觉得很感人	正面	正面
沈腾又一次爆屏了	正面	正面
很好看，不错电影	正面	正面
电影满分情节感人 刚子真的是顶流👍	正面	正面
哭死了😭😭😭	正面	正面
还行吧，没有想象中的效果。	负面	正面
可以，不错，别要求太多，你行你上！	正面	正面
好看，太好看了，含腾量超高	正面	正面
好看必须10	正面	正面
特别好看，不愧是麻花出品，喜剧加科幻	正面	正面
演技还行，值得一看	正面	正面
多好看啊，不懂那些说不好看的，哪儿来的水军啊，多少钱一条啊，有钱一起挣	正面	正面
笑点很多哦 结尾蛮煽情	正面	正面
不错，笑点放低，挺不错的	正面	正面
点映，看的第一场，真的好看！沈腾和马丽合作，从没让人失望！	正面	正面
这两颗心是给沈腾的	负面	正面
差的要死，看到一半睡着了	负面	负面
好看 喜欢沈腾马丽和袋鼠	正面	正面
非常好看强烈推荐，笑的我肚子痛	正面	正面
怎么说呢，好多点都能让人猜到，个人感觉如果结尾不是变成英雄色彩，而是基于面试中的幻想可能笑点会好吧。不过片段中搞笑的地方还是不错的。	负面	正面
沈腾老师演的电影都超级好看	正面	正面
很不错，有很多笑料	正面	正面
永远支持沈腾马丽！！！	正面	正面
挺有意思的 就是看睡着了	正面	正面
很好看，很感动，在片场眼泪流得全无形象，也对地球的未来很忧心！	正面	正面
纯粹就是个垃圾电影！火星救援山寨版！关键笑点也很低！我真的看睡着了！唉……总结就是大烂片！	负面	负面
可以，沈叔叔演的，超级棒，非常清晰，金刚鼠也不错	正面	正面
开心麻花从来没让我失望过	正面	正面
挺不错，有意思	正面	正面
推荐观看 感人	正面	正面
非常的非常的好	正面	正面
"可以，既好看又感动，这部电影我看预告片时，以为金刚鼠是敌人，而看的时候，却发现金刚鼠前面遇见沈腾时是敌人，后面其实成为好朋友了！让我惊㤉，感动画面中最让我感动的是沈腾为了拯救世界，决定用炸弹炸了大石头，石头名字为""圆周率2″。于是把金刚鼠独自放进一个仓，把它送回了地球。我觉得这部电影票房可以涨到50亿以上，应该还算行，其它的不说了！ 对了，喜欢玩和平精英的小伙伴们一定要去看，因为两个公司合作7哦！😗😛"	正面	正面
奈斯，值得推荐	正面	正面
还行，值得一看！	正面	正面
又有谁在搞笑的外表下读懂了他的孤独呢	正面	正面
热血又浪漫，玛丽沈腾，天生一对。	正面	正面
真的又好看又好笑又好哭 呜呜呜 强烈推荐大家去看	正面	正面
前半段笑点满满，后半段泪点满满	正面	正面
家人们好看极了，快去看全球次顶流腾哥的月球生活吧！	正面	正面
真的非常好看，剧情很好，上一秒还在笑，下一秒就哭成泪人，很好看的😍	正面	正面
演技非常棒！	正面	正面
很好看 很有笑点	正面	正面
还不错没有沈腾啥也不是，全是消费自己！剧本烂的要死！	正面	正面
很不错 致敬了流浪地球	正面	正面
剧情有点拖沓	负面	正面
十分之九给特效 配乐 画面 十分之一个给沈马这两位演员 其他的都会尬住我….	正面	负面
好看，不愧是沈腾和马丽	正面	正面
前面爆笑后面好哭	正面	正面
特别好看 值得二刷	正面	正面
袋鼠那段蛮搞笑的，虽然结局悲惨，但过程很幸福	正面	正面
在生活中 总有这样一种人 普普通通是他的人设 碌碌无为是他的日常 但在关键时刻总能挺身而出 逆光而行	正面	正面
开心麻花的电影每次都稳不住去看，看了无喜无悲，六分不能再多了	负面	负面
剧情一般，结局一般。和以前不一样，这次看都没怎么笑。	负面	正面
一般般，有点无聊！	正面	负面
非常适合带娃看，孩子很兴奋。	正面	正面
太好看了吧！	正面	正面
剧情不落俗套，虽然看过预告，但还是很好笑，画面细节处理的很好，演金刚鼠的演员未来可期，有笑点也有泪点，值回票价，反正就是一定要去看噢！	正面	正面
不是很搞笑，有点感人	正面	正面
全程爆笑哈哈哈哈哈哈哈	正面	正面
很喜欢，很搞笑	正面	正面
剧情跌宕起伏 特效堪数一绝 明星阵容强大 最后睡的很香	正面	正面
特效是有目共睹的，剧情在今天科幻的大环境下部分有些老套，总体值得大家欣赏下。	正面	正面
本来想去看的，但一看到主演名单有沈腾一下就不想去了，太闹腾了，而且还是无厘头的所谓搞笑	负面	负面
吹爆《独行月球》 笑😃的脸都痛，哭😭的眼都瞎 ​真的真的好好看，有谁没能看过，我真的会难过[可怜][可怜]	正面	正面
剧情还可以，独孤月前后思想变化表现得很明显，演员们的演技都不错	正面	正面
感受一般，还是美国大片感觉好吧。国内这种片子总是有种不伦不类的感觉。	负面	负面
沈腾，马丽合作，无敌	正面	正面
非常好看快去看	正面	正面
很好笑，当喜剧看很不错	正面	正面
别的不说，反正把我逗得很开心。要泪点有泪点。	正面	正面
还好吧，也没有很好笑。中间有一段还有点感人了，差点泪目，沈腾又把我们逗笑了。期待以后有更好的作品。	正面	正面
刚开始没看进去，后来还可以！	正面	正面
高潮迭起，不错	正面	正面
沈腾演技在线，结局是流浪地球的路子，习惯了开心麻花纯喜剧的结局，看这个电影还有点不太适应，总得来说还不错，笑点不少，泪点也多😂😂😂	正面	正面
好好看 笑点泪点都有 腾哥继续加油	正面	正面
感觉在剧情高潮要是配上香港乐队Dear jane的那首《人类不宜飞行》绝配啊	正面	正面
好看非常推荐	正面	正面
蛮不错的，值得一看。	正面	正面
不賴 好看 好笑	正面	正面
哈哈哈真的很搞笑	正面	正面
挺好的，到最后挺感动的	正面	正面
构建人类命运共同体、牺牲小我成就大我……	正面	正面
搞笑，最后感动	正面	正面
感觉一般 还行	负面	正面
好看，电影里的学问：甚嚣尘上	正面	正面
很值得一看 超级好看	正面	正面
炒鸡好看 巨巨巨巨巨好看 救命 题材很不戳 演员的演技就更棒了 让观众感到欢乐的同时 有掺杂了悲伤的成分 一环扣一环	正面	正面
敢干，强行搞笑，强行煽情，太空题材不如爱死机一集十分钟	负面	负面
刚子咱们回地球吧！ 沈腾这是能拿影帝的演技啊，感觉他不想只在喜剧打转的野心了。	正面	正面
前半部分还可以	正面	正面
在笑声中掺杂着感动，影片里简单的事物中也蕴含着不浅的哲理，引人深思🤔。一切偶然事件的发生，其间也许都存在着某种必然的联系，得与失是可以相互转化的。        影片前期埋了许多伏笔后期有所挖掘，剧情有多处转折，大多出现得都不突兀。        与现实世界中的探月历史进行了联动，但却不完全相同。使用同音字的专有名词，可以让观众在联想到现实的同时，又能立马察觉到它与现实不同，还能兼具笑点。让我不禁叹“语言的魅力”！此片中还出现了与地理、物理等专业有关的知识，这说明它也不是完全虚构的。        平凡之人不凡，平凡造就伟大。主角的“中间人”身份，一定程度上体现出了 中庸 思想。人具有社会属性，离开社会就很难生存，这点在主角的身上可以看出。        开头和结尾的动画元素，与多数的同类影片不同，却也能较为直观的展示出 电影制作者所想要表达的信息。也许还能节省制作成本？        片尾还有彩蛋的进度条，有趣！群演的名字也在片尾出现了。“主角不死定律”好像也在被慢慢的打破。	正面	正面
感受不错！！！	正面	正面
强烈推荐大家看看	正面	正面
一个字，烂！	负面	负面
不错 非常搞笑 也蛮感动  可以去看看 值得推荐 有笑有泪 可以	正面	正面
演技不用多说，都是老戏骨，非常好看，也很感人！	正面	正面
少年，你相信光吗?喜剧最后bd了	正面	正面
挺好的片尾曲好听	正面	正面
特别搞笑，极力推荐	正面	正面
沈腾马丽再合体冲	正面	正面
剧情比较创新，有点搞笑整体来说还是不错的	正面	正面
还行 还可以吧	正面	正面
特效很棒棒，剧情也很感人。	正面	正面
好看好看 笑点很多，也有泪点。袋鼠🦘拉车什么的太酷了吧。配上酷玩的BGM，感觉蹭～一下子就上来了 。好评好评好评！！！	正面	正面
前面爆笑，后面揪心	正面	正面
前面有多好笑 后面就能苦的多惨	正面	正面
不出意外的话这部《独行月球》应该是今年2022年暑期档的票房冠军了，这部电影是沈腾继《夏洛特烦恼》、《一念天堂》、《西虹市首富》、《飞驰人生》之后第五次担当男主角，含腾量也几乎接近百分之百。这部电影不再是单纯的喜剧片，而是上升到了另一个境界，欢笑之余还能带点感动。这部电影里有一些笑点稍微有点尴尬，拍一部喜剧电影也好，演小品和说相声也好，不要为了搞笑而搞笑。比如说黄才伦在这部电影里饰演的解说员希望太阳不要下落，因为沈腾饰演的独孤月被落在月球上了。他只有追逐太阳才能回到地球上，太阳一旦下落就下落特烦恼，这个梗就用这个很牵强，李成儒在这部电影里贡献的搞笑戏份并不多。他的一开场坐着轮椅在台阶上滚了下去，这个笑点就很自然，不牵强，后面希望马蓝星坐在她的位置上也很自然也不牵强。但后面李成儒问独孤月还能不能回到地球上，马蓝星说有戏，李成儒说那就系（试）一系（试），这里的笑点有很牵强，在科研所这么严肃的地方怎么还说上方言了呢？常远给马蓝星一杯100℃刚烧开的水，马蓝星想都没想就直接喝了下去，喝完之后带着沙哑的嗓音说到“还没有找到独孤月是吧？”我没喝过100℃刚烧开的水，人喝完那样的水真的会使自己的嗓音	正面	正面
好看好看，沈腾马丽果然是绝配	正面	正面
好看，搞笑中带着感动	正面	正面
还不错，电影挺好的	正面	正面
好看nice	正面	正面
都还比较喜欢	正面	正面
剧透！主角死了！	负面	正面
可惜最后独孤月还是死了😭	正面	正面
科幻与喜剧结合，好看	正面	正面
个人觉得是继《夏洛特烦恼》中最好看的一部，总体还行，就是有些刻意搞笑的部分觉得挺尴尬的	正面	正面
可以看看呀	正面	正面
精彩 高兴阖家欢乐的好剧	正面	正面
搞笑又感人的	正面	正面
值得看一看！	正面	正面
好看，喜剧又带着感动。一会笑一会哭的。	正面	正面
非常好 沈腾马丽怎么会让人失望呢	正面	正面
很不错  和同事一起去看的	正面	正面
挺好看的，搞笑，励志，感人	正面	正面
一般般。不过看下也还行。不要期望太高也不会失望太大。	负面	正面
开心麻花登场，就是搞笑	正面	正面
剧情有趣，主演的演技不错 🎉闪光点 画面感有些致敬经典影片 🌅 画面 笑点密集 😂 笑点	正面	正面
以看喜剧片的心情进影院，结果后半截都在煽情，感觉像沈腾一个人的电影，不过还是可以看的，也算拍的不错了	正面	正面
有笑有泪，一部好电影！	正面	正面
无厘头喜剧，呵呵一笑	正面	正面
又笑又哭很可以的	正面	正面
主要是喜欢沈腾	正面	正面
作为喜剧片和科幻片，都显得不是很突出	正面	正面
好看的，棒棒棒	正面	正面
超级好看，前面很好笑，后面很好哭	正面	正面
超级好看！搞笑点特别多！但是这个电影院的环境像蒸桑拿一样！热得要死！！！	正面	正面
开心麻花团队挺好的	正面	正面
好的 即搞笑，又感人。	正面	正面
电影很不错	正面	正面
就很好啊、可爱的袋鼠。看到了宣传、感恩那个默默扮演袋鼠的你、谢谢付出。	正面	正面
很好看，特别	正面	正面
所有笑点都在晚上看过了  再看一次也有内容	正面	正面
很一般，强行搞笑最为致命。	正面	负面
笑点自己体会	正面	正面
没有想象中好看。	负面	负面
好看，确实不错	正面	正面
挺不错的，很好看	正面	正面
挺好看的，总能在绝境逢生，好看。	正面	正面
沈腾马丽的作品直至没让我失望过！	正面	正面
不知道咋说，笑点一般，逻辑一般，剧情一般	负面	负面
电视真的好看，剧情搞笑又感人，全程都是笑点，推荐	正面	正面
全程都在尴尬  动不动强行煽情 一点都不感动 中国少点烂片吧	负面	负面
凑乎吧奔着沈腾马丽去的	正面	正面
搞笑类型的电影 可以带女朋友一起观看	正面	正面
科幻就科幻，喜剧就喜剧。包袱丢的很随意。全场就笑了一次。	负面	正面
炒鸡好看！！！！太欢乐了	正面	正面
又有笑又有泪 真的很好看永远相信沈马组合👏	正面	正面
很好看，有趣	正面	正面
可以 好看不错👌👍	正面	正面
冲着沈腾看看吧，很一般的电影！不推荐！	负面	负面
演技都不错，就是剧情比较普通了，笑点有点少	正面	正面
不错，马丽沈腾很搞笑，虽然最后笑中带泪，总体还不错，推荐哦	正面	正面
剧情好，画质清晰，演技超群！	正面	正面
因为好评去看的，感觉没有达到预期。 前面的挺好笑，后面的就很无聊了，还没有西虹市首富好看呢。	正面	负面
剧情不错，搞笑中又赚了一把泪。	正面	正面
可惜进错片场了，也挺好的	正面	正面
1234567899	正面	正面
没有传说的那么好。笑点都很勉强，下半场都快看睡着了	负面	负面
电影大半部分都很搞笑，不愧是开心麻花出品的，但是最后又很感人，非常值得冲（悄悄说一句，独孤月实在太惨了）	正面	正面
你是没我好收拾宿舍四是旧金山市	正面	正面
很多梗，挺搞笑的	正面	正面
好看，故事精彩	正面	正面
刚子！刚子！	正面	正面
沈腾的电影每次最后都是引深出一个大道理，但是我个人觉得这个片，沈腾的戏份很多，隔着月球和地球的距离，没能看出两人实际上是的配合，但有很多心里的共鸣，值得尝试看看	正面	正面
好看，笑点很多，袋鼠演技超神	正面	正面
我看到了中国科幻电影工业化的成长！目前国产科幻电影特效最高水平！ 🌅 画面  🌟 推荐	正面	正面
剧情设计非常往往在你最紧张的时候，会抛出包袱，令你怦然大笑，整场看下来，令我又哭又笑的，还有就是沈腾叔叔的演技太好了	正面	正面
很男朋友在一起后看的第一步电影🎬好评	正面	正面
挺好的 搞笑	正面	正面
非常不错，演技很好	正面	正面
喜剧来讲还不错 内容单一 不丰富	正面	正面
沈腾每一次都能带来不一样的惊喜，宇宙级的浪漫真的很爱！又笑有泪真的能戳到观影者的每个点！刚子也是太可爱了太喜欢了，这部电影真的很值得去电影院看！永远支持沈腾马丽！！！	正面	正面
很精彩！期待沈腾和马丽的下部电影！！	正面	正面
非要深究科幻的本质去看探索宇宙，看个喜剧能让人思想升华？那你去看资本论，去看道德经，开心就好，喜欢，十分，点32个赞！	正面	正面
还可以，拖炸弹那里看不明白！没电了叫袋鼠拖，没拖到炸弹，最后炸弹怎么回到基地的？是删除了部分吗？	负面	正面
还可以，挺搞笑的！	正面	正面
无聊死了，几次想离开，又臭又长	负面	负面
好烂的电影，	负面	负面
为了反向绕月时能顺利回到基地，而安插的袋鼠有点尴尬，因为袋鼠在剧情里太拟人化了，还能认认真真的坐在副驾驶位，没有挣扎，没有闹腾，知道沈腾在救它，还有表情回应，这袋鼠的智商也太高了，确实尬！	负面	负面
虽然看到沈腾马丽没有不笑的，但剧情老套，实在一般。特效也一般吧，不抱期待可以去看一下，顶多算及格电影。	负面	负面
看的热泪盈眶，喜怒哀乐都有了	正面	正面
人设挺好的，剧情有点扎心	正面	正面
killing明敏敏敏咯去在皮笑肉	正面	正面
太棒啦，非常喜欢沈腾	正面	正面
好电影不错可以去看一下	正面	正面
剧情一般，搞笑一般，画面还行，演技因为剧情，突破不了	正面	负面
剧情前面笑到流泪，后面难过到流泪。	正面	正面
搞笑好看又感人，有机会的姐妹们看去尝试看一下，推荐🆗	正面	正面
全程笑点满满，看了还想在看系列。	正面	正面
片子不错含腾量很高，开心麻花还得靠沈腾支撑。	正面	正面
非常好，值得	正面	正面
科幻拉满的同时  搞笑不断	正面	正面
好看 🎉闪光点	正面	正面
影片还可以 但是没有达到我的预期效果 以为会很好看的 就一般偏上吧 没有特别好看	正面	正面
太好哭了有喜点🈶泪点都快去冲鸭家人们	正面	正面
实在太烂了，不知道为什么那么高分	负面	负面
剧情不怎么样，但还是笑了，良	正面	正面
很好看!!!!一会儿感人一会儿搞笑!!!	正面	正面
真不错呢，前面的剧情是喜剧，后面很感人	正面	正面
人人有责任感	正面	正面
推荐去看，非常好的电影。	正面	正面
说实话呢，这部电影还是值得去看的，有笑也泪。也值得给这么高的评分。笑点是腾哥自我安慰豁达的精神，泪呢，也是告诉我们人类在天灾面前是渺小的，为了大我牺牲小我。刚开始被笑得眼泪出来了，后来呢，是被感动的哭了，虽然我没有哭，但是呢，好多小姐姐还是哭了。国产片能拍出这个效果应该算是很不错了。腾哥，加油！ 唯一不喜欢的就是怎么会有黄子韬，说实话真的喜欢他不起来。	正面	正面
非常好看，有笑有泪	正面	正面
超级好看！！！非常建议去看一看，演技都非常好👍	正面	正面
有情怀，又搞笑，有担当	正面	正面
沈腾和马丽果然才是最佳搭档，好看，搞笑，感人	正面	正面
剧情还可以，适合陪孩子一起看	正面	正面
科幻和喜剧的结合，相当于我是演员里最会唱歌的。总体水准之上吧	正面	正面
值得一看！很搞笑	正面	正面
超爱沈腾，剧情也很有意思，开怀大笑的	正面	正面
相当不错了啊	正面	正面
挺不错的，沈氏幽默。	正面	正面
剧情很不错可以进入 蛮搞笑又感动	正面	正面
只能说，太好看了！	正面	正面
完全没有意思！开心麻花前几部🤮🤮🤮	负面	负面
剧情还行吧  就是去开心的  让我笑了就行	正面	正面
烂中烂 19.9都是浪费	负面	负面
前期可以，搞笑。后期煽情了不好看	正面	正面
还行吧，没事可以看看	正面	正面
世界这么大 我们还会遇见	正面	正面
悲感场景居多，缺少了以往的快乐	正面	正面
还行，正常电影	正面	正面
值得一看，很感人	正面	正面
开头笑死，结局哭死的一部剧	正面	正面
笑中带泪，像多部经典致敬，电影非常好看，值得推荐。	正面	正面
今年少有的好电影了 剧情也不拖沓 两小时观影看的很爽	正面	正面
太假了，对沈腾最失望的一部电影，笑点低剧情不真实	负面	负面
推荐观看！！	正面	正面
如果后面不煽情的话就更好了！	正面	正面
挺好看的  好评	正面	正面
当袋鼠拉车慢镜划过地球，当Take Me Home Country Roads深情吟唱，当万盏光束冲破黑暗射向苍穹，整个人的鸡皮疙瘩都起来了。“希望即救赎”！沈马组合就是可以点燃这个暑期档！不接受反驳。台词包袱和致敬梗密集投炸，全场的观众都笑得此起彼伏，值得一看。	负面	正面
剧情紧凑，搞笑	正面	正面
有笑料，也很符合大环境	正面	正面
反正看到一半睡了一觉	正面	负面
咱们老百姓就不要站在专业影评人的角度看问题了，我忙忙叨叨工作了一周，周六下班的晚上跟老公一起吃个饭，看个电影，坐在电影院里看到沈腾出场我俩相视一笑，然后整场电影都在哈哈哈，虽然结尾不是很喜欢，但电影着实让我俩暂时把生活中的烦恼抛在脑后放声大笑了，这就够了！	正面	正面
我觉得腾哥演的真好 我不管剧情啥样我就觉得腾哥演技永远在线，笑点和泪点拿捏得你是死死的，让你又哭又笑的 我觉得这就是一个好演员应该能让观众做到这一点就够了，支持腾哥，马丽演技也在线，只要和腾哥一起出演就重来没有下过线的时候，腾马一出手就知道有没有，反正我喜欢看	正面	正面
一般不好笑真的	负面	负面
烂片！笑点在哪？笑点在哪？？	负面	负面
提条件回来还真没命定	正面	正面
好哭好笑 巨无敌好看	正面	正面
给我的松鼠大哥好评！	正面	正面
蛮不错的，。	正面	正面
还不错，笑点也挺多，影院爆满，笑声不断。还看到了火星救援，流浪地球，楚门的世界，星际穿越的影子。	正面	正面
可以  值得购买	正面	正面
还可以吧～！	负面	正面
很不错！完美！	正面	正面
我觉得挺好看的，刚子非常的好玩，最后独孤月属实给我感动到了	正面	正面
🌟 推荐 个人本来就很喜欢沈腾 这部作品既戳笑点又戳泪点	正面	正面
开始搞笑，最后感动，很不错的一部片子，影院环境好，画质清晰，最主要的是我们“包场”了🤫	正面	正面
剧情OK画质OK	正面	正面
好看，棒棒哒！	正面	正面
超级好看，力推，腾叔叔	正面	正面
不错，搞笑，又煽情。	正面	正面
非常好看喔。不错额。	正面	正面
一般吧，剧情就是那种套路，搞笑部分挺好的，但是很短暂，后来都是叙事了，以为是喜剧结果是悲剧，沈腾演技挺好	正面	正面
真是挺好看的，大制作，这比那些说几亿几亿的特效好多了，真的，	正面	正面
满分 非常好看	正面	正面
很好看 跟小姨一起看的	正面	正面
！！赞赞赞赞	正面	正面
演技不错，故事情节也很感人	正面	正面
沈腾的百亿票房男神的称号不白叫，基本每部电影都能给人带来欢乐和感动，不错，可以带着孩子看一看	正面	正面
好，沈腾马丽YYDS	正面	正面
好 很好 不错	正面	正面
挺好，不错。	正面	正面
真的不错，可冲	正面	正面
还挺好看的 但是部分人说无聊  一个人有一个人的看法吧	正面	正面
真的好看呜呜呜沈马组合YYDS！！！马丽真的好温柔的感觉，让我看到了爱情的模样，虽然有遗憾但是美好长存，有笑点也有泪点	正面	正面
个人觉得很有趣，虽然最后的电筒那段确实有点扯，但并不影响我是去笑的。	正面	正面
可以不错前期爆笑	正面	正面
很好看，马丽的台词太有感染力了	正面	正面
剧情很赞，对之前经典电影都有致意，搞笑和科幻元素满满，值得观看	正面	正面
电影总体很好看	正面	正面
强烈推荐，沈叔叔的剧YYDS，喜剧➕励志	正面	正面
还行，无聊啊	负面	正面
近半年多没有一部好看的电影，沈腾马丽主演的电影终于又来了，虽然不算很好看，不过也值了票价	正面	正面
说好的喜剧呢，垃圾 ，不伦不类	负面	负面
非常搞笑，观众从头到尾一直在笑。我好久没看电影了，也好久没这样笑过了。这部电影虽然是喜剧，但笑中带泪，有那么一丝心酸。每个演员的表演都很好，特效很好。这是一部很难得的喜剧电影，也是一部很难得的中国电影，值得一看。	正面	正面
和袋鼠那段很搞笑，结局很感人	正面	正面
挺有喜剧色彩	正面	正面
剧情可以笑点不足，演技可以，画面不错	正面	正面
爆点少 部分笑点硬凑（发型 着装 邋遢形象），看的人疲乏，结局强硬升华	正面	正面
非常好看大家快去，我还想看一遍，喜剧中透过人生😂😂	正面	正面
很棒，很搞笑也很煽情，笑的不行，哭的也稀里哗啦的，结局没有反转，但是又很合理，不过分夸张	正面	正面
沈腾从来不让人失望👍🏼👍🏼提前团购的券，非常划算，周边吃喝玩乐的地方也很多，非常便捷	正面	正面
很好棒极了👏	正面	正面
总的来说还不错。	正面	正面
不错的电影，应该还有第二部	正面	正面
Good, Good!	正面	正面
一贯的风格。有点无聊。	正面	正面
喜剧的尽头是悲剧。一个悲喜剧，但是不影响他的质量，巨好看 😊 演技  🌅 画面  🎉闪光点  🌟 推荐	正面	正面
好看 近年来看过最好的电影	正面	正面
凑合吧。。。	正面	正面
电影非常经常，影院环境服务都很不错	正面	正面
科技感很强 主题新颖 背景一点都不假 又搞笑 又感人 🌟 推荐	正面	正面
还不错吧，跟夏洛特烦恼肯定没办法比。	正面	正面
特别棒，非常好	正面	正面
沈腾的电影总是不会让人失望	正面	正面
太好看了太太太太太好看了，沈腾马丽绝了，太推荐了	正面	正面
剧情紧凑，内容搞笑，结局有点过于煽情	正面	正面
不错   棒极了  很感动	正面	正面
剧情一般，孩子想看喜剧就陪她看一下。	正面	正面
怕是开心麻花最烂的一部了。搞笑不是搞笑，科幻不是科幻。剧情乱七八糟的。违背了开心麻花的初心。	负面	负面
很好看。非常棒	正面	正面
非常bang	正面	正面
一般般,也没有很搞笑。最后的煽情环节也不是很感人。	负面	负面
来自孤独的浪漫 一开始，我看了简介，以为这是部喜剧。而全片的前大部分，确实是喜剧。可是看到后来，我觉得这才是世界上最高级的浪漫，来自孤独的浪漫。从相信光，到坚定的牺牲，我们看到了一个普通人，一个不可能存在的普通人的坚毅，他也不再普通了。影片的最后，有那么一瞬间，我想到了在烈士陵园嬉戏的孩子们。这种对孤独的冲刺，就是星辰大海中最后，最高尚的浪漫。	正面	正面
剧情很好，世界这么大我们无法探索完全，只能走一步看一步，我们应该加油，应该珍惜每一天	正面	正面
非常好看！！？？	正面	正面
真的很好沈马永不be	正面	正面
很好看 ….	正面	正面
好看好看，有笑有泪，完美	正面	正面
喜剧永远那么感动	正面	正面
含腾量100👍👍👍爆赞	正面	正面
又搞笑又感人最后有彩蛋！！！	正面	正面
有喜有悲但愿地球没有末日。珍惜眼前人珍惜拥有的一切珍惜生命。  🎉闪光点	正面	正面
😊 演技 🎉闪光点	正面	正面
很好看，情节有喜有悲，挺感人的	正面	正面
画面不错，剧情一般般啊	负面	正面
开心麻花YYDS👍	正面	正面
特有的腾式幽默，笑着流泪	正面	正面
虽然说没有非常出彩，但说是一部合格的电影那是绰绰有余的。故事完整，剧情流畅，节奏把握的也不错，音乐也好评，特效什么的也很好，中间再夹杂这一些笑点和感动点。不能说票价超值，但值回票价和那120分钟的时间是没问题的。经过这么长时间的疫情，中国电影需要这样的片子来提振士气和市场。希望中国电影能早日回到疫情前的繁荣。	正面	正面
还好，搞笑的喜剧片	正面	正面
电影不错，夏天看看轻松	正面	正面
画面真实，笑点泪点全部具备，很好的一部电影，推荐大家去电影院观看	正面	正面
很值得一看！	正面	正面
好看好看剧情还不错	正面	正面
还是有被内涵到，剧情可以本身就是喜剧片重要的大家开怀大笑我觉得就可以了，至于细节方面有的还可以，有的就比较扯了；但整体而言电影还是不错的，最后还有自我奉献精神这点还是要赞滴	正面	正面
沈马yyds！！剧情可能有点bug，但是真的很搞笑，还有点感动，在近几年的国产电影里算不错的了！！	正面	正面
我想给12分，太好玩了。	正面	正面
出乎意料 蛮不错的	正面	正面
不玩了头溪谢谢谢谢谢谢	正面	正面
还不错直的一看	正面	正面
又搞笑又伤感含腾量100	正面	正面
非常好看的一个剧，一开始非常搞笑，但是呢到中间有感人的地方，这次的麻花团可以说是含腾量99％，剧中的顶流刚子太可爱了不愧是顶流哈哈哈哈哈哈，故事情节也非常大胆有想法，末日题材非常的到位，经管结局不是大团圆但是我感觉故事的精髓就在于这个be的结局，总之非常好看的剧，好评！！！	正面	正面
一切众生搭都是自己想说面试通知不	正面	正面
非常好，搞笑感人	正面	正面
剧情一般，有强制煽情嫌疑	负面	负面
好很搞笑。不错。	正面	正面
值得看的电影	正面	正面
还行吧，笑点也多	正面	正面
一般吧，有点看困了。	负面	负面
剧情很好..	正面	正面
比起搞笑，这部电影催泪励志的地方其实更多 如果你喜欢沈叔叔，这次绝对是有惊喜的体验，让你看到他的不一样	正面	正面
很搞笑，虽然有些片段强行煽情，不过也还行，不会太尴尬，把中间人诠释得很到位	正面	正面
还行吧，今天心情不好的时候看的。	负面	正面
精彩搞笑🤪又感动😹，画质清晰	正面	正面
还好吧！有搞笑的部分。但是总体来说不尽如人意，那么高的评分哪儿来的	负面	正面
就那样吧不好看	负面	负面
又搞笑又感动 值得一看	正面	正面
感觉一般，缺乏内涵	正面	负面
推荐 体验还不错	正面	正面
不错的电影，挺好看的，依然支持沈腾和马丽的电影，看见他们就想笑	正面	正面
2022年看过最好的电影🎦	正面	正面
好 不错 值得一看	正面	正面
本来想看看喜剧，结果看了三部电影，好看值得	正面	正面
好看喜欢沈腾马丽	正面	正面
开始很搞笑，后来就很煽情 ，牺牲一个人而拯救了所有人。	正面	正面
前期笑噶了，后期直接破防。很好看，强推，沈马永远的神	正面	正面
还可以， 可能期待太高了吧	正面	正面
不严谨，笑点低	负面	负面
配角是只袋鼠👋商业骗钱片	负面	负面
好看的 🌟 推荐	正面	正面
非常的不错👍	正面	正面
很一般，没有想象中的那么好看	负面	负面
电影非常不错，观影感很棒 推荐这家	正面	正面
一般般，没有达到我的预期。	负面	负面
还行，前面不错，最后结局不行，跟流浪地球差不多	正面	正面
电影不错，看得我又笑又哭，拍摄效果很赞。 再说银泰这家电影院，也真是黑的，我带着两个120以下的娃，一个90多点，说一张电影票一大只能带一小的，大孩子补票，这也是我看电影以来第一次补票，补票也就算了，还补了全票，也是无语了	正面	正面
蛮好看的就是有些东西比较仓促	正面	正面
又搞笑又感人，一个普通人的故事，一个中间人的故事，但是又不普通，不中间的故事 「你不是一个人」是集体的浪漫 最后地球的光环，是一个男人的浪漫 「刚子」虽然没有台词，但一次又一次带来了希望 喜欢一个人，也许也只是一个人的事儿	正面	正面
走喜剧风格。但给人一种孤独感，画面还是不错的	正面	正面
可以，值得观看	正面	正面
很好看 含腾量极高😎	正面	正面
一般吧，不至于九分	正面	正面
有欢笑有泪点，喜欢沈腾和马丽，10分好评	正面	正面
前面好看，后面强行催泪就不好看了	正面	正面
还好啊，有搞笑的点也有催情的点	正面	正面
很震撼好看！	正面	正面
好看，很搞笑，值得观看。	正面	正面
有笑点有泪点，我觉得都很自然，很棒的啊	正面	正面
不错不错非常好看的电影，昨天七夕去看的，满场，推荐大家带孩子去看！	正面	正面
真心好看！腾哥啊	正面	正面
剧情还可以 就是电影厅跟汗蒸房差不多吧	正面	正面
挺好😊 ，没了，没有了，够了够了	正面	正面
超好看！笑中带泪	正面	正面
給我感覺有點拉扯感 剛有想哭的感觉 然后给拉一下转个弯又笑起来 不過整體給我感覺可以就是沒有到我的心里期待感 要是有調整就好了	正面	正面
一般就前面好笑后面又开始悲，真是不知从何开始中国喜剧作品不论是小品还是影视都是头喜尾悲，真不知道说什么是为了体现艺术吗，那这艺术可太可悲了，不建议来电影院看等他发网上把吧	负面	负面
还不错～～～	正面	正面
没有以前的作品有意思，笑点与泪点有点强行，略尬。但是还是比其他的搞笑电影好看。有一点点失望吧，本来对腾哥的电影期待更高的	正面	负面
个人感觉啊一般，不搞笑，平平淡淡	负面	负面
太棒棒哒支持	正面	正面
真的巨巨巨巨巨巨巨巨巨巨巨巨巨巨好看！家人们冲！！	正面	正面
非常不错，印象非常好。	正面	正面
非常喜欢剧情	正面	正面
剧情有点狗血，不伦不类，搞笑不搞笑，科幻又毫无逻辑乱七八糟，强制煽情	负面	负面
笑中有泪，两大主角演的都不错。很自然很感人	正面	正面
好看，等下线继续刷起。。	正面	正面
挺好，喜欢沈腾，	正面	正面
一流的特效，三流的剧情，推荐指数6星	负面	正面
9.3的评分不知道怎么来的，不是我的菜	正面	负面
不错呀！！！！	正面	正面
**片  写着喜剧 然后在这**人	负面	负面
感觉不错，值得推荐	正面	正面
让我有末日的想象和危机感。最喜欢全地球所有人把灯点亮的那一幕。万物一体，全世界就剩一个人，你还恨谁？全世界就你和金刚袋鼠，是对抗争斗还是结盟为友？	正面	正面
剧情一般，但是沈马有影响力票房差不了	负面	正面
好看死 给我都去看	正面	正面
果然爱护环境是我们现在唯一能做的事情，沈腾马丽的喜剧真的很可以，会继续支持他们！	正面	正面
一般般不会很好看	负面	负面
很好看的电影，笑点很多	正面	正面
看着还行吧！	正面	正面
好看，真的特别好看	正面	正面
好看，值得去看！	正面	正面
很搞笑 挺好的	正面	正面
一般般，都是老梗了，奔着沈腾去的	负面	负面
挺好看，值得推荐。	正面	正面
还可以吧，没有很惊喜，也么有很失望！带着孩子去看的，宝宝也没有哭的稀里哗啦，但是该笑得笑点，确实哈哈哈哈。有喜，有乐，有悲，有壮举，有英雄，有爱情。一些特效做的很好，虽然有部分梗比较老。而且有很多小伏笔，能让人进入故事，不至于情景脱离，影片感人和笑点穿插的节奏也可以，还突破了喜剧传统的he模式。还是很推荐的！银河系真的太漂亮了！ 今天真是元气满满的一天啊~	正面	正面
￼特别好看。	正面	正面
很好看，剧情不错	正面	正面
超赞🖖，前天小姑娘性格超级好，开朗活泼大方	正面	正面
挺搞笑的 可以和朋友去看	正面	正面
挺好好看，热闹，有喜有泪	正面	正面
广告太多 剧情太尬，很多地方都是抄袭的	负面	负面
永远53940相信沈叔叔    马丽姐姐	正面	正面
剧情跌宕起伏，笑点泪点齐飞，想象力超丰富。真正的不输好莱坞的大片。弘扬了人类永不言弃的精神，在疫情肆虐的当下犹其有意义。此片应全球推广。	正面	正面
还行吧，别考虑太多深度的话，看看也看看，当放松了	正面	正面
很搞笑，有趣	正面	正面
不知道笑点在哪里，不知如何评价	负面	正面
老婆觉得好看，小孩也觉得好看，但可能期待值太高了，有少少失落！	正面	正面
超级好看值得推荐	正面	正面
我觉得电影是搞笑浪漫，特效做得很好，很多画面都超好看。 徐志胜黄子韬的出现很惊喜很好笑。 有很多点沈叔叔的表演都让我泪目，虽然剧情走向大概能猜到，但沈叔叔和马丽的演绎让我为马蓝星和独孤月的爱情惋惜。 马蓝星，带我回家。	正面	正面
合格的喜剧片 笑点不断	正面	正面
挺不错的 就是影院画质感人	正面	正面
生蚝非常好吃！来了3次！！大家一起来啊	正面	正面
科幻部分有些逻辑硬伤，但剧情完整节奏好，笑点泪点我都能get到一点不尴尬	正面	正面
虽然有些小瑕疵，但是作为喜剧片，还是值得一看，有笑点有泪点。	正面	正面
还可以，但是有些冗长，如果短小精悍些，我觉得可能会更好。	正面	正面
可能是期望过高，观后感觉非常一般。	负面	负面
还行，不错的	正面	正面
有笑更有泪，麻花最有内涵的一部了，我个人给满分，顶顶顶	正面	正面
非常好看，感人的电影，喜欢	正面	正面
我极力推荐，	正面	正面
还不错…挺好看的	正面	正面
很不错，但是彩蛋在哪？	正面	正面
个人觉得挺好看的，沈腾咋样都是笑点。	正面	正面
开心麻花的每一部电影我都看过，这部电影确实还行，没那么烂，也没他们说的那么好，中规中矩，能看，搞笑也还行。特效也还好，总之还算值得一看。	正面	正面
还可以，不错！	正面	正面
真的巨感人又喜感	正面	正面
剧情低俗，差评	负面	负面
笔记本狐尼克	正面	正面
无聊看看挺好的	正面	正面
非常的古斗非常的完美	正面	正面
非常好看 观影场地宽敞	正面	正面
剧情不错，画质清晰	正面	正面
看睡着了。本来想好好放松下，可我根本没笑出来。。。	负面	负面
非常好。很好看	正面	正面
前半段是比较搞笑的，后半段有点煽情了些，特效做得很好，还是不错的一部电影	正面	正面
太一般了，没笑点，剧情一般	负面	负面
在娱乐和煽情间徘徊，作为喜剧不纯粹，作为科幻又不严谨，只能说一般般。	负面	负面
可以的，有笑点，也有感动点，不强行煽情，题材也挺新颖，国内这些好片多一点，我就能每周都去看一部电影了	正面	正面
个人感觉一般般 看的还有点犯困	负面	负面
一般般  不怎么搞笑！	正面	负面
在IMAX厅观看这部影片可以说是一种相当的享受，毕竟本片在视听方面做的算是相当扎实，我希望能看到的就是更加成熟的类型片，因为只有这样的电影才能更加吸引观众进场观看，苛责影片的缺点无非是烂俗的包袱无法轻松舍去，但我们这个时代最缺乏的就是前进的勇气。	正面	正面
很搞笑，也很感动	正面	正面
好 非常好。	正面	正面
腾式搞笑！值得一看！	正面	正面
全程笑点，孩子特别开心😁	正面	正面
很快就可好看	正面	正面
有笑点有泪点但是剧情有点牵强是不能带脑子看的喜剧	正面	正面
原本以為是喜劇片。沒想到看得莪老淚縱橫。	正面	正面
挺好 沈马从未让观众失望	正面	正面
还可以吧～看的时候挺开心的	正面	正面
值得观看，搞笑的很	正面	正面
哈卷娜都没走	正面	正面
很好笑，一如既往的喜欢	正面	正面
太尬了，侮辱智商	负面	负面
好看呀快来看吧	正面	正面
剧情、细节都很一般	负面	负面
挺好看的就是这样	正面	正面
电影很有趣，剧情了解也很完美，浪漫	正面	正面
搞笑的一比，墙裂推荐	正面	正面
很不错，笑点很多，值得	正面	正面
挺好的，很有意义，笑点也有	正面	正面
好，可以去看	负面	正面
电影特别好看，但是个人感受被观影后排四个女生毁了，全程在讲话，在笑，声音真的不小，有婉约地提醒声音太大，她们还不以为意，甚至踢凳子，素质。但是电影真的有戳到我，哭惨了，沈腾那段哭的演技惊到我，演得很好，全程不出戏，然后他和刚子分别的那一幕真的很感动	正面	正面
出色的喜剧明星，看到他的脸就笑了	正面	正面
一般不是特别好看	负面	负面
《独行月球》好看！也是一部“含腾量”极高的喜剧电影了。令人惊喜的是，这一部来自中国的电影，在太空和喜剧结合的表达上，走出了一条与国外太空科幻题材不一样的路，既拓展了国内科幻和喜剧类型的融合，也让观众在电影院中随着剧情的喜剧点笑声不断。	正面	正面
可以说很搞笑了	正面	正面
超级好看超级喜欢，特别推荐	正面	正面
好看值得你看呦	正面	正面
很好看，感觉前面铺垫稍长了一点，但笑点满满，并且没有尿点。有些点有点点套路，猜得到后面，有些点在意料之外，很不错，我是有三个地方看哭了T﹏T，推荐大家去看看	正面	正面
好看  推荐 大屏幕看真的很奈斯	正面	正面
挺好的 袋鼠特效也棒棒的沈腾马丽组合演技也是很棒哦	正面	正面
算是开心麻花近几年内的良心之作，有笑点有泪点。	正面	正面
前面挺搞笑后面感人	正面	正面
还可以吧，冲黄渤去de	正面	正面
挺不错的半年来最满意的片，该有的都有了	正面	正面
好看好看的很呢！	正面	正面
真的很好看笑点拉满虽然结局be但是不影响它好看	正面	正面
很搞笑的剧情，挺好看的	正面	正面
可以可以，很好看，后面有一点伤感。该说不说，真的很好看。	正面	正面
很好看有泪点有笑点	正面	正面
真的有笑点有泪点，真的好看好哭好笑	正面	正面
其它的先不说，电影特效真的做得太棒了，特别真实。如果是3D效果可能会更好。	正面	正面
我吹爆它，不看绝对后悔！	正面	正面
自己看看有多谢特😅	负面	正面
说实话有点失望，剧情有点为了推进而推进，没有达到开心麻花的水准，开心麻花最烂片之一	负面	负面
挺好，推荐观看。	正面	正面
好好看，呜呜呜，原谅我泪点低哭的稀里哗啦	正面	正面
非常好看，太逗了，也太感人了	正面	正面
剧情曲折，感人，人物描写突出，具有良好的艺术性。演员表情丰富。	正面	正面
觉得还可以吧？	正面	正面
那个金刚鼠笑死我	正面	正面
沈腾有什么坏心思呢？只不过让每个人都笑得肚子腾。 周日带着娃看了沈腾马丽主演的独行月球，之前完全没有被剧透过，只知道票房很高。妥了，可是没想到剧情还是大大超出意外，超出惊喜！太好看了！太搞笑了！我家娃不停地爆笑，前仰后合的！5星，不行，必须得10星好评！要演技🈶️演技，要特效🈶️特效，要创意🈶️创意！只能说沈腾马丽继续加油，开心快乐就承包给您们啦！	正面	正面
我很喜欢，，	正面	正面
很一般吧，现在的电影越来越没有新意。	负面	负面
难看的死，票房不知道为什么会这么高 看这电影的心情真的和麻花一样	负面	负面
一般，不太好	正面	负面
含腾量99.99%💫推荐指数🌟一家人一起看的 大家都说不错 哈哈～	正面	正面
还可以，虽然电影还能更精致些，但观影体验还不错	正面	正面
这次沈腾太牛了，演技炸裂，剧情也很好，全程无尿点，时时爆笑，偶尔又让人很感动。	正面	正面
马丽和沈腾小品铁粉，就喜欢他们表演，	正面	正面
那月亮不是我的月亮，但有一刻，月光确实照在了我身上。 所爱隔山海，山海皆可平 马蓝星和独孤月，终是意难平，又是心之所向。我对你的爱，就是月球与地球之间的距离	正面	正面
不搞笑，半程打瞌睡	负面	负面
还行，还可以	正面	正面
不错tui j	正面	正面
挺好看的真不错！	正面	正面
不错值得去看看	正面	正面
沈腾之最烂的电影	负面	负面
画面很好，剧情开心	正面	正面
挺好看的，拍得不错	正面	正面
好笑也好哭，搞笑的地方搞笑，让人哭的地方也让人很感动	正面	正面
个人愚见，近两年好像看过的所有新上映的电影都不太行，没有之前在电影看的心灵奇旅，烈日灼心等电影的感觉了，这部片子嘘头太大了，感觉是炒作的缘故吧（比如侏罗纪三明明还不错，评分那么低）看完没有任何波动，甚至不如人生大事，神探等影片，这部片子看的一脸懵逼，太尬了，笑点低幼化，适合带小孩儿观看	负面	负面
好看好看。 。	正面	正面
搞笑感人，好看	正面	正面
剧情很有趣，棒极了	正面	正面
幽默大笑之后引人深思	正面	正面
还可以吧，带妈妈去看，老人说挺好看的，	正面	正面
很不错，我看着很好，大天地影城人不多，很好！	正面	正面
值得一看 该笑笑该哭哭	正面	正面
不错，搞笑是搞笑	正面	正面
挺好看的，搞笑部分很多	正面	正面
美团赞助的吗	正面	负面
很棒，超喜欢沈马组合	正面	正面
烂片 适合过年放放让小孩子笑笑	负面	负面
搞笑成分很足，也很感人，团结就是力量，就是希望，一个人的牺牲，换来全人类的生存，伟大！	正面	正面
剧情还不错，	正面	正面
毫无意义，浪费时间	负面	负面
真的好看前面搞笑后面感人 🌟 推荐  😊 演技  😭 哭点  😂 笑点	正面	正面
还不错吧啦啦啦	正面	正面
第一次看电影打哈欠！	负面	负面
看懂了真实的沈腾希望逃离电影，回归有灯照亮的家，回归有人期盼的现实社会。	正面	正面
好看！沈马组合YYDS	正面	正面
玩尬的是吧？	负面	负面
电影很不错。	正面	正面
挺好，很好。	正面	正面
沈腾表演可圈可点，表演得非常棒！	正面	正面
电影一般，凑活	正面	正面
其他的不说了     不过后期的话有好多星空片段可以做壁纸了	正面	正面
电影一点都不好看，画面粗糙！	负面	负面
还不错👌👍👌	正面	正面
好看，去看了就知道了，	正面	正面
比预计的好看	正面	正面
真心不错，笑的开心，哭得稀里哗啦	正面	正面
演的不错，！	正面	正面
我感觉还是可以的，实话，我感受到更多的是感动	正面	正面
是真的赞，不管画风，还是特效，还是腾叔叔的搞笑，所有所有都应该值10分，我可太喜欢了，特别是【你不是人】那里，气氛都烘到那儿了我都要哭出来了，一下子给我笑趴下了，好久没有看过那么有泪有笑的电影了，谢谢官配马丽和腾叔叔。	正面	正面
冲着沈腾去的！但是剧情改一下可能更好	正面	正面
很好看 棒极了	正面	正面
航天员本来是很严肃的，弄的嬉皮笑脸的，中间还贯穿那么多爱情线路，一个堂堂的航天员跟个花痴一样追一个领导，真是低俗又做作，沈腾的演技太浮夸了，里面还弄那么多煽情的场面，强行煽情，那些看直播的观众安排的也太刻意了，随时都在看着电视，表演各个浮夸至极，结尾还特别像流浪地球，又是牺牲他自己拯救全宇宙，一摸一样，总体来说作为喜剧太低俗做作，作为科幻片又太小儿科老套路	负面	负面
感觉还不错，反正挺搞笑的。	正面	正面
好看哦，值得观看	正面	正面
有点尬，很一般哇	负面	负面
结尾些许老套	正面	正面
不算喜剧吧个人觉得	负面	正面
超棒，超感动，超有趣！	正面	正面
都睡着了 提前走的	负面	负面
像看小品一样 ，打发时间图轻松一刻，主旨讲到了人的孤独	正面	正面
挺好的  挺有意思  有哭有笑	正面	正面
笑点多，含“腾”量也高，不过比起之前两部感觉还是有些逊色	正面	正面
特别推荐去看，很感人，很搞笑	正面	正面
特别搞笑，特别逗，本来以为独孤月能回来的，一丢丢不完美。	正面	正面
娱乐片，还可以！	正面	正面
非常搞笑的电影，喜欢沈腾和马丽	正面	正面
在上半年电影市场持续低迷下，这部电影是一剂强心剂。根据赵石同名漫画改编，还原了漫画很多经典场景。有笑有泪，确实不错。而且含腾率100％，沈马组合还用考虑嘛？无脑冲！	正面	正面
挺好看，搞笑的	正面	正面
电影院里比今年的msi还那个啥	负面	正面
